what is the highest point in ent0:=:state ?	add_operation:-:_highest add_node:-:A add_type_node:-:_place arg_node:-:A add_node:-:B add_edge:-:_loc arg_node:-:A arg_node:-:B add_entity_node:-:ent0:=:state arg_node:-:B end_operation:-:arg ope_for:-:A return:-:A	ent0:=:state:::florida:=:state
what are the high points of states surrounding ent0:=:state ?	add_node:-:B add_node:-:A add_edge:-:_high_point arg_node:-:B arg_node:-:A add_edge:-:_loc arg_node:-:A arg_node:-:B add_type_node:-:_state arg_node:-:B add_node:-:C add_edge:-:_next_to arg_node:-:B arg_node:-:C add_entity_node:-:ent0:=:state arg_node:-:C return:-:A	ent0:=:state:::mississippi:=:state
what state has the shortest river ?	add_node:-:A add_type_node:-:_state arg_node:-:A add_node:-:B add_edge:-:_loc arg_node:-:B arg_node:-:A add_operation:-:_shortest add_type_node:-:_river arg_node:-:B end_operation:-:arg ope_for:-:B return:-:A	
what is the tallest mountain in ent0:=:country ?	add_operation:-:_highest add_node:-:A add_type_node:-:_mountain arg_node:-:A add_node:-:B add_edge:-:_loc arg_node:-:A arg_node:-:B add_entity_node:-:ent0:=:country arg_node:-:B end_operation:-:arg ope_for:-:A return:-:A	ent0:=:country:::usa:=:country
what is the capital of ent0:=:state ?	add_node:-:A add_type_node:-:_capital arg_node:-:A add_node:-:B add_edge:-:_loc arg_node:-:A arg_node:-:B add_entity_node:-:ent0:=:state arg_node:-:B return:-:A	ent0:=:state:::maine:=:state
what are the populations of states through which ent0:=:river run ?	add_node:-:B add_node:-:A add_edge:-:_population arg_node:-:B arg_node:-:A add_type_node:-:_state arg_node:-:B add_node:-:C add_edge:-:_traverse arg_node:-:C arg_node:-:B add_entity_node:-:ent0:=:river arg_node:-:C add_type_node:-:_river arg_node:-:C return:-:A	ent0:=:river:::mississippi:=:river
name all the lakes of ent0:=:country ?	add_node:-:A add_type_node:-:_lake arg_node:-:A add_node:-:B add_edge:-:_loc arg_node:-:A arg_node:-:B add_entity_node:-:ent0:=:country arg_node:-:B return:-:A	ent0:=:country:::usa:=:country
which states border states through which ent0:=:river traverses ?	add_node:-:A add_type_node:-:_state arg_node:-:A add_node:-:B add_edge:-:_next_to arg_node:-:A arg_node:-:B add_type_node:-:_state arg_node:-:B add_node:-:C add_edge:-:_traverse arg_node:-:C arg_node:-:B add_entity_node:-:ent0:=:river arg_node:-:C return:-:A	ent0:=:river:::mississippi:=:river
what is the highest mountain in ent0:=:state ?	add_operation:-:_highest add_node:-:A add_type_node:-:_mountain arg_node:-:A add_node:-:B add_edge:-:_loc arg_node:-:A arg_node:-:B add_entity_node:-:ent0:=:state arg_node:-:B end_operation:-:arg ope_for:-:A return:-:A	ent0:=:state:::alaska:=:state
what is the population of ent0:=:state ?	add_node:-:B add_node:-:A add_edge:-:_population arg_node:-:B arg_node:-:A add_entity_node:-:ent0:=:state arg_node:-:B return:-:A	ent0:=:state:::illinois:=:state
name all the rivers in ent0:=:state ?	add_node:-:A add_type_node:-:_river arg_node:-:A add_node:-:B add_edge:-:_loc arg_node:-:A arg_node:-:B add_entity_node:-:ent0:=:state arg_node:-:B return:-:A	ent0:=:state:::colorado:=:state
in which state does the highest point in ent0:=:country exist ?	add_node:-:B add_node:-:A add_edge:-:_loc arg_node:-:B arg_node:-:A add_type_node:-:_state arg_node:-:A add_operation:-:_highest add_type_node:-:_place arg_node:-:B add_node:-:C add_edge:-:_loc arg_node:-:B arg_node:-:C add_entity_node:-:ent0:=:country arg_node:-:C end_operation:-:arg ope_for:-:B return:-:A	ent0:=:country:::usa:=:country
which state is ent0:=:city located in ?	add_node:-:A add_type_node:-:_state arg_node:-:A add_node:-:B add_edge:-:_loc arg_node:-:B arg_node:-:A add_type_node:-:_city arg_node:-:B add_entity_node:-:ent0:=:city arg_node:-:B return:-:A	ent0:=:city:::denver:=:city
what is the lowest point in ent0:=:state ?	add_operation:-:_lowest add_node:-:A add_type_node:-:_place arg_node:-:A add_node:-:B add_edge:-:_loc arg_node:-:A arg_node:-:B add_entity_node:-:ent0:=:state arg_node:-:B end_operation:-:arg ope_for:-:A return:-:A	ent0:=:state:::texas:=:state
how many states have a city called ent0:=:city ?	add_operation:-:_count add_node:-:B add_type_node:-:_state arg_node:-:B add_node:-:C add_edge:-:_loc arg_node:-:C arg_node:-:B add_entity_node:-:ent0:=:city arg_node:-:C end_operation:-:_count ope_for:-:B ope_return:-:A return:-:A	ent0:=:city:::rochester:=:city
which capitals are in the states that border ent0:=:state ?	add_node:-:A add_type_node:-:_capital arg_node:-:A add_node:-:B add_edge:-:_loc arg_node:-:A arg_node:-:B add_type_node:-:_state arg_node:-:B add_node:-:C add_edge:-:_next_to arg_node:-:B arg_node:-:C add_entity_node:-:ent0:=:state arg_node:-:C return:-:A	ent0:=:state:::texas:=:state
how many people live in ent0:=:city ?	add_node:-:B add_node:-:A add_edge:-:_population arg_node:-:B arg_node:-:A add_entity_node:-:ent0:=:city arg_node:-:B return:-:A	ent0:=:city:::austin:=:city
what states have rivers named ent0:=:river ?	add_node:-:A add_type_node:-:_state arg_node:-:A add_node:-:B add_edge:-:_loc arg_node:-:B arg_node:-:A add_entity_node:-:ent0:=:river arg_node:-:B return:-:A	ent0:=:river:::colorado:=:river
what is the size of ent0:=:state ?	add_node:-:B add_node:-:A add_edge:-:_size arg_node:-:B arg_node:-:A add_entity_node:-:ent0:=:state arg_node:-:B return:-:A	ent0:=:state:::texas:=:state
what is the shortest river in ent0:=:country ?	add_operation:-:_shortest add_node:-:A add_type_node:-:_river arg_node:-:A add_node:-:B add_edge:-:_loc arg_node:-:A arg_node:-:B add_entity_node:-:ent0:=:country arg_node:-:B end_operation:-:arg ope_for:-:A return:-:A	ent0:=:country:::usa:=:country
what are the major cities of ent0:=:country ?	add_node:-:A add_type_node:-:_major arg_node:-:A add_type_node:-:_city arg_node:-:A add_node:-:B add_edge:-:_loc arg_node:-:A arg_node:-:B add_entity_node:-:ent0:=:country arg_node:-:B return:-:A	ent0:=:country:::usa:=:country
which state border ent0:=:state ?	add_node:-:A add_type_node:-:_state arg_node:-:A add_node:-:B add_edge:-:_next_to arg_node:-:A arg_node:-:B add_entity_node:-:ent0:=:state arg_node:-:B return:-:A	ent0:=:state:::kentucky:=:state
what is the population of ent0:=:state ?	add_node:-:B add_node:-:A add_edge:-:_population arg_node:-:B arg_node:-:A add_entity_node:-:ent0:=:state arg_node:-:B return:-:A	ent0:=:state:::oregon:=:state
what states have a city named ent0:=:city ?	add_node:-:A add_type_node:-:_state arg_node:-:A add_node:-:B add_edge:-:_loc arg_node:-:B arg_node:-:A add_entity_node:-:ent0:=:city arg_node:-:B return:-:A	ent0:=:city:::austin:=:city
what is the highest elevation in ent0:=:state ?	add_operation:-:_highest add_node:-:A add_type_node:-:_place arg_node:-:A add_node:-:B add_edge:-:_loc arg_node:-:A arg_node:-:B add_entity_node:-:ent0:=:state arg_node:-:B end_operation:-:arg ope_for:-:A return:-:A	ent0:=:state:::south_carolina:=:state
how many people live in ent0:=:city ?	add_node:-:B add_node:-:A add_edge:-:_population arg_node:-:B arg_node:-:A add_entity_node:-:ent0:=:city arg_node:-:B return:-:A	ent0:=:city:::austin_tx:=:city
what are the rivers in ent0:=:state ?	add_node:-:A add_type_node:-:_river arg_node:-:A add_node:-:B add_edge:-:_loc arg_node:-:A arg_node:-:B add_type_node:-:_state arg_node:-:B add_entity_node:-:ent0:=:state arg_node:-:B return:-:A	ent0:=:state:::texas:=:state
what is the lowest point of ent0:=:state ?	add_operation:-:_lowest add_node:-:A add_type_node:-:_place arg_node:-:A add_node:-:B add_edge:-:_loc arg_node:-:A arg_node:-:B add_entity_node:-:ent0:=:state arg_node:-:B end_operation:-:arg ope_for:-:A return:-:A	ent0:=:state:::colorado:=:state
what is the population of ent0:=:city ?	add_node:-:B add_node:-:A add_edge:-:_population arg_node:-:B arg_node:-:A add_entity_node:-:ent0:=:city arg_node:-:B return:-:A	ent0:=:city:::atlanta:=:city
what rivers are in ent0:=:state ?	add_node:-:A add_type_node:-:_river arg_node:-:A add_node:-:B add_edge:-:_loc arg_node:-:A arg_node:-:B add_entity_node:-:ent0:=:state arg_node:-:B return:-:A	ent0:=:state:::utah:=:state
what river runs through the most states ?	add_operation:-:_most add_node:-:A add_type_node:-:_river arg_node:-:A add_node:-:B add_edge:-:_traverse arg_node:-:A arg_node:-:B add_type_node:-:_state arg_node:-:B end_operation:-:arg_count ope_for:-:A ope_for:-:B return:-:A	
what is the ent0:=:city ?	add_node:-:B add_node:-:A add_edge:-:_population arg_node:-:B arg_node:-:A add_entity_node:-:ent0:=:city arg_node:-:B return:-:A	ent0:=:city:::sacramento:=:city
could you tell me what is the highest point in ent0:=:state ?	add_operation:-:_highest add_node:-:A add_type_node:-:_place arg_node:-:A add_node:-:B add_edge:-:_loc arg_node:-:A arg_node:-:B add_type_node:-:_state arg_node:-:B add_entity_node:-:ent0:=:state arg_node:-:B end_operation:-:arg ope_for:-:A return:-:A	ent0:=:state:::oregon:=:state
which states does ent0:=:river run through ?	add_node:-:A add_type_node:-:_state arg_node:-:A add_node:-:B add_edge:-:_traverse arg_node:-:B arg_node:-:A add_entity_node:-:ent0:=:river arg_node:-:B add_type_node:-:_river arg_node:-:B return:-:A	ent0:=:river:::mississippi:=:river
what are the major cities in the smallest state in ent0:=:country ?	add_node:-:A add_type_node:-:_major arg_node:-:A add_type_node:-:_city arg_node:-:A add_node:-:B add_edge:-:_loc arg_node:-:A arg_node:-:B add_operation:-:_smallest add_type_node:-:_state arg_node:-:B add_node:-:C add_edge:-:_loc arg_node:-:B arg_node:-:C add_entity_node:-:ent0:=:country arg_node:-:C end_operation:-:arg ope_for:-:B return:-:A	ent0:=:country:::usa:=:country
how high is ent0:=:place ?	add_node:-:B add_node:-:A add_edge:-:_elevation arg_node:-:B arg_node:-:A add_entity_node:-:ent0:=:place arg_node:-:B return:-:A	ent0:=:place:::guadalupe_peak:=:place
what river runs through ent0:=:state ?	add_node:-:A add_type_node:-:_river arg_node:-:A add_node:-:B add_edge:-:_traverse arg_node:-:A arg_node:-:B add_entity_node:-:ent0:=:state arg_node:-:B return:-:A	ent0:=:state:::illinois:=:state
how long is ent0:=:river ?	add_node:-:B add_node:-:A add_edge:-:_len arg_node:-:B arg_node:-:A add_entity_node:-:ent0:=:river arg_node:-:B add_type_node:-:_river arg_node:-:B return:-:A	ent0:=:river:::mississippi:=:river
how high is the highest point in the largest state ?	add_node:-:B add_node:-:A add_edge:-:_elevation arg_node:-:B arg_node:-:A add_operation:-:_highest add_type_node:-:_place arg_node:-:B add_node:-:C add_edge:-:_loc arg_node:-:B arg_node:-:C add_operation:-:_largest add_type_node:-:_state arg_node:-:C end_operation:-:arg ope_for:-:C end_operation:-:arg ope_for:-:B return:-:A	
what is the area of ent0:=:state ?	add_node:-:B add_node:-:A add_edge:-:_area arg_node:-:B arg_node:-:A add_entity_node:-:ent0:=:state arg_node:-:B return:-:A	ent0:=:state:::south_carolina:=:state
what are the states through which the longest river runs ?	add_node:-:A add_type_node:-:_state arg_node:-:A add_operation:-:_longest add_node:-:B add_edge:-:_traverse arg_node:-:B arg_node:-:A add_type_node:-:_river arg_node:-:B end_operation:-:arg ope_for:-:B return:-:A	
where is ent0:=:city ?	add_node:-:B add_node:-:A add_edge:-:_loc arg_node:-:B arg_node:-:A add_entity_node:-:ent0:=:city arg_node:-:B return:-:A	ent0:=:city:::new_orleans:=:city
in what state is ent0:=:place ?	add_node:-:B add_node:-:A add_edge:-:_loc arg_node:-:B arg_node:-:A add_type_node:-:_state arg_node:-:A add_entity_node:-:ent0:=:place arg_node:-:B return:-:A	ent0:=:place:::mount_mckinley:=:place
what state has highest elevation ?	add_node:-:A add_type_node:-:_state arg_node:-:A add_node:-:B add_edge:-:_loc arg_node:-:B arg_node:-:A add_operation:-:_highest add_type_node:-:_place arg_node:-:B end_operation:-:arg ope_for:-:B return:-:A	
what is the size of ent0:=:state ?	add_node:-:B add_node:-:A add_edge:-:_size arg_node:-:B arg_node:-:A add_entity_node:-:ent0:=:state arg_node:-:B return:-:A	ent0:=:state:::california:=:state
what is the smallest state that borders ent0:=:state ?	add_operation:-:_smallest add_node:-:A add_type_node:-:_state arg_node:-:A add_node:-:B add_edge:-:_next_to arg_node:-:A arg_node:-:B add_entity_node:-:ent0:=:state arg_node:-:B end_operation:-:arg ope_for:-:A return:-:A	ent0:=:state:::texas:=:state
how many citizens in ent0:=:state ?	add_node:-:B add_node:-:A add_edge:-:_population arg_node:-:B arg_node:-:A add_entity_node:-:ent0:=:state arg_node:-:B return:-:A	ent0:=:state:::alabama:=:state
in which state is ent0:=:city ?	add_node:-:B add_node:-:A add_edge:-:_loc arg_node:-:B arg_node:-:A add_type_node:-:_state arg_node:-:A add_entity_node:-:ent0:=:city arg_node:-:B return:-:A	ent0:=:city:::rochester:=:city
how many states in ent0:=:country does the shortest river run through ?	add_operation:-:_count add_node:-:B add_type_node:-:_state arg_node:-:B add_node:-:C add_edge:-:_loc arg_node:-:B arg_node:-:C add_entity_node:-:ent0:=:country arg_node:-:C add_node:-:D add_edge:-:_traverse arg_node:-:D arg_node:-:B add_operation:-:_shortest add_type_node:-:_river arg_node:-:D end_operation:-:arg ope_for:-:D end_operation:-:_count ope_for:-:B ope_return:-:A return:-:A	ent0:=:country:::usa:=:country
what is the biggest state in ent0:=:country ?	add_operation:-:_largest add_node:-:A add_type_node:-:_state arg_node:-:A add_node:-:B add_edge:-:_loc arg_node:-:A arg_node:-:B add_entity_node:-:ent0:=:country arg_node:-:B end_operation:-:arg ope_for:-:A return:-:A	ent0:=:country:::usa:=:country
what is the area of the largest state ?	add_node:-:B add_node:-:A add_edge:-:_area arg_node:-:B arg_node:-:A add_operation:-:_largest add_type_node:-:_state arg_node:-:B end_operation:-:arg ope_for:-:B return:-:A	
where is ent0:=:place ?	add_node:-:B add_node:-:A add_edge:-:_loc arg_node:-:B arg_node:-:A add_entity_node:-:ent0:=:place arg_node:-:B return:-:A	ent0:=:place:::mount_whitney:=:place
how many states does ent0:=:state border ?	add_operation:-:_count add_node:-:B add_type_node:-:_state arg_node:-:B add_node:-:C add_edge:-:_next_to arg_node:-:C arg_node:-:B add_entity_node:-:ent0:=:state arg_node:-:C end_operation:-:_count ope_for:-:B ope_return:-:A return:-:A	ent0:=:state:::iowa:=:state
which states does the longest river cross ?	add_node:-:A add_type_node:-:_state arg_node:-:A add_node:-:B add_edge:-:_traverse arg_node:-:B arg_node:-:A add_operation:-:_longest add_type_node:-:_river arg_node:-:B end_operation:-:arg ope_for:-:B return:-:A	
what river flows through ent0:=:state ?	add_node:-:A add_type_node:-:_river arg_node:-:A add_node:-:B add_edge:-:_traverse arg_node:-:A arg_node:-:B add_entity_node:-:ent0:=:state arg_node:-:B return:-:A	ent0:=:state:::kansas:=:state
what is the population of ent0:=:city ?	add_node:-:B add_node:-:A add_edge:-:_population arg_node:-:B arg_node:-:A add_entity_node:-:ent0:=:city arg_node:-:B return:-:A	ent0:=:city:::austin_tx:=:city
what is the capital of ent0:=:state ?	add_node:-:A add_type_node:-:_capital arg_node:-:A add_node:-:B add_edge:-:_loc arg_node:-:A arg_node:-:B add_entity_node:-:ent0:=:state arg_node:-:B return:-:A	ent0:=:state:::vermont:=:state
which states border ent0:=:state ?	add_node:-:A add_type_node:-:_state arg_node:-:A add_node:-:B add_edge:-:_next_to arg_node:-:A arg_node:-:B add_entity_node:-:ent0:=:state arg_node:-:B return:-:A	ent0:=:state:::colorado:=:state
how long is ent0:=:river ?	add_node:-:B add_node:-:A add_edge:-:_len arg_node:-:B arg_node:-:A add_entity_node:-:ent0:=:river arg_node:-:B return:-:A	ent0:=:river:::mississippi:=:river
what state has the largest population density ?	add_operation:-:_largest add_node:-:A add_type_node:-:_state arg_node:-:A add_node:-:B add_edge:-:_density arg_node:-:A arg_node:-:B end_operation:-:arg ope_for:-:B return:-:A	
what states border ent0:=:state ?	add_node:-:A add_type_node:-:_state arg_node:-:A add_node:-:B add_edge:-:_next_to arg_node:-:A arg_node:-:B add_entity_node:-:ent0:=:state arg_node:-:B return:-:A	ent0:=:state:::georgia:=:state
what is the capital of ent0:=:state ?	add_node:-:A add_type_node:-:_capital arg_node:-:A add_node:-:B add_edge:-:_loc arg_node:-:A arg_node:-:B add_entity_node:-:ent0:=:state arg_node:-:B return:-:A	ent0:=:state:::pennsylvania:=:state
what are the biggest rivers in ent0:=:state ?	add_operation:-:_longest add_node:-:A add_type_node:-:_river arg_node:-:A add_node:-:B add_edge:-:_loc arg_node:-:A arg_node:-:B add_entity_node:-:ent0:=:state arg_node:-:B end_operation:-:arg ope_for:-:A return:-:A	ent0:=:state:::texas:=:state
what is the longest river in ent0:=:country ?	add_operation:-:_longest add_node:-:A add_type_node:-:_river arg_node:-:A add_node:-:B add_edge:-:_loc arg_node:-:A arg_node:-:B add_entity_node:-:ent0:=:country arg_node:-:B end_operation:-:arg ope_for:-:A return:-:A	ent0:=:country:::usa:=:country
what is the capital of ent0:=:state ?	add_node:-:A add_type_node:-:_capital arg_node:-:A add_node:-:B add_edge:-:_loc arg_node:-:A arg_node:-:B add_entity_node:-:ent0:=:state arg_node:-:B return:-:A	ent0:=:state:::utah:=:state
what state has the smallest population density ?	add_operation:-:_smallest add_node:-:A add_type_node:-:_state arg_node:-:A add_node:-:B add_edge:-:_density arg_node:-:A arg_node:-:B end_operation:-:arg ope_for:-:B return:-:A	
which capitals are not major cities ?	add_node:-:A add_type_node:-:_capital arg_node:-:A add_operation:-:_not add_type_node:-:_major arg_node:-:A add_type_node:-:_city arg_node:-:A end_operation:-:_not return:-:A	
what is the biggest city in ent0:=:state ?	add_operation:-:_largest add_node:-:A add_type_node:-:_city arg_node:-:A add_node:-:B add_edge:-:_loc arg_node:-:A arg_node:-:B add_entity_node:-:ent0:=:state arg_node:-:B end_operation:-:arg ope_for:-:A return:-:A	ent0:=:state:::nebraska:=:state
what is the population of ent0:=:state ?	add_node:-:B add_node:-:A add_edge:-:_population arg_node:-:B arg_node:-:A add_entity_node:-:ent0:=:state arg_node:-:B return:-:A	ent0:=:state:::texas:=:state
what is the shortest river in ent0:=:country ?	add_operation:-:_shortest add_node:-:A add_type_node:-:_river arg_node:-:A add_node:-:B add_edge:-:_loc arg_node:-:A arg_node:-:B add_entity_node:-:ent0:=:country arg_node:-:B end_operation:-:arg ope_for:-:A return:-:A	ent0:=:country:::usa:=:country
what is the population of ent0:=:state ?	add_node:-:B add_node:-:A add_edge:-:_population arg_node:-:B arg_node:-:A add_entity_node:-:ent0:=:state arg_node:-:B return:-:A	ent0:=:state:::rhode_island:=:state
what is the state with the lowest point ?	add_node:-:A add_type_node:-:_state arg_node:-:A add_node:-:B add_edge:-:_loc arg_node:-:B arg_node:-:A add_operation:-:_lowest add_type_node:-:_place arg_node:-:B end_operation:-:arg ope_for:-:B return:-:A	
what is the longest river in ent0:=:state ?	add_operation:-:_longest add_node:-:A add_type_node:-:_river arg_node:-:A add_node:-:B add_edge:-:_loc arg_node:-:A arg_node:-:B add_entity_node:-:ent0:=:state arg_node:-:B end_operation:-:arg ope_for:-:A return:-:A	ent0:=:state:::new_york:=:state
what is the longest river that runs through a state that borders ent0:=:state ?	add_operation:-:_longest add_node:-:A add_type_node:-:_river arg_node:-:A add_node:-:B add_edge:-:_traverse arg_node:-:A arg_node:-:B add_type_node:-:_state arg_node:-:B add_node:-:C add_edge:-:_next_to arg_node:-:B arg_node:-:C add_entity_node:-:ent0:=:state arg_node:-:C end_operation:-:arg ope_for:-:A return:-:A	ent0:=:state:::tennessee:=:state
how many major cities are in ent0:=:state ?	add_operation:-:_count add_node:-:B add_type_node:-:_major arg_node:-:B add_type_node:-:_city arg_node:-:B add_node:-:C add_edge:-:_loc arg_node:-:B arg_node:-:C add_entity_node:-:ent0:=:state arg_node:-:C end_operation:-:_count ope_for:-:B ope_return:-:A return:-:A	ent0:=:state:::arizona:=:state
what are the neighboring states for ent0:=:state ?	add_node:-:A add_node:-:B add_edge:-:_next_to arg_node:-:A arg_node:-:B add_type_node:-:_state arg_node:-:A add_entity_node:-:ent0:=:state arg_node:-:B return:-:A	ent0:=:state:::michigan:=:state
what state that borders ent0:=:state is the largest ?	add_operation:-:_largest add_node:-:A add_type_node:-:_state arg_node:-:A add_node:-:B add_edge:-:_next_to arg_node:-:A arg_node:-:B add_entity_node:-:ent0:=:state arg_node:-:B end_operation:-:arg ope_for:-:A return:-:A	ent0:=:state:::texas:=:state
what is the shortest river ?	add_operation:-:_shortest add_node:-:A add_type_node:-:_river arg_node:-:A end_operation:-:arg ope_for:-:A return:-:A	
how many states border the state that borders the most states ?	add_operation:-:_count add_node:-:B add_type_node:-:_state arg_node:-:B add_node:-:C add_edge:-:_next_to arg_node:-:B arg_node:-:C add_operation:-:_most add_type_node:-:_state arg_node:-:C add_node:-:D add_edge:-:_next_to arg_node:-:C arg_node:-:D add_type_node:-:_state arg_node:-:D end_operation:-:arg_count ope_for:-:C ope_for:-:D end_operation:-:_count ope_for:-:B ope_return:-:A return:-:A	
which state is the largest city in ent0:=:state in ?	add_node:-:A add_type_node:-:_state arg_node:-:A add_node:-:B add_edge:-:_loc arg_node:-:B arg_node:-:A add_operation:-:_largest add_type_node:-:_city arg_node:-:B add_node:-:C add_edge:-:_loc arg_node:-:B arg_node:-:C add_entity_node:-:ent0:=:state arg_node:-:C end_operation:-:arg ope_for:-:B return:-:A	ent0:=:state:::montana:=:state
what is the population of ent0:=:city ?	add_node:-:B add_node:-:A add_edge:-:_population arg_node:-:B arg_node:-:A add_entity_node:-:ent0:=:city arg_node:-:B return:-:A	ent0:=:city:::washington_dc:=:city
what is the most populous city in ent0:=:state ?	add_operation:-:_largest add_node:-:B add_node:-:A add_edge:-:_population arg_node:-:B arg_node:-:A add_type_node:-:_city arg_node:-:B add_node:-:C add_edge:-:_loc arg_node:-:B arg_node:-:C add_entity_node:-:ent0:=:state arg_node:-:C end_operation:-:arg ope_for:-:A return:-:B	ent0:=:state:::texas:=:state
what is the capital of ent0:=:state ?	add_node:-:A add_type_node:-:_capital arg_node:-:A add_node:-:B add_edge:-:_loc arg_node:-:A arg_node:-:B add_entity_node:-:ent0:=:state arg_node:-:B return:-:A	ent0:=:state:::hawaii:=:state
what is capital of ent0:=:state ?	add_node:-:A add_type_node:-:_capital arg_node:-:A add_node:-:B add_edge:-:_loc arg_node:-:A arg_node:-:B add_entity_node:-:ent0:=:state arg_node:-:B return:-:A	ent0:=:state:::iowa:=:state
where is ent0:=:city ?	add_node:-:B add_node:-:A add_edge:-:_loc arg_node:-:B arg_node:-:A add_entity_node:-:ent0:=:city arg_node:-:B return:-:A	ent0:=:city:::san_diego:=:city
what are the major cities in ent0:=:state ?	add_node:-:A add_type_node:-:_major arg_node:-:A add_type_node:-:_city arg_node:-:A add_node:-:B add_edge:-:_loc arg_node:-:A arg_node:-:B add_entity_node:-:ent0:=:state arg_node:-:B return:-:A	ent0:=:state:::delaware:=:state
what is the lowest point in ent0:=:state ?	add_operation:-:_lowest add_node:-:A add_type_node:-:_place arg_node:-:A add_node:-:B add_edge:-:_loc arg_node:-:A arg_node:-:B add_entity_node:-:ent0:=:state arg_node:-:B end_operation:-:arg ope_for:-:A return:-:A	ent0:=:state:::louisiana:=:state
which state has the highest peak in the country ?	add_operation:-:_highest add_node:-:A add_type_node:-:_state arg_node:-:A add_node:-:B add_edge:-:_loc arg_node:-:B arg_node:-:A add_type_node:-:_mountain arg_node:-:B end_operation:-:arg ope_for:-:B return:-:A	
what ent0:=:state city has the largest population ?	add_operation:-:_largest add_node:-:C add_entity_node:-:ent0:=:state arg_node:-:C add_node:-:A add_edge:-:_loc arg_node:-:A arg_node:-:C add_node:-:B add_edge:-:_population arg_node:-:A arg_node:-:B add_type_node:-:_city arg_node:-:A end_operation:-:arg ope_for:-:B return:-:A	ent0:=:state:::texas:=:state
what capital is the largest in ent0:=:country ?	add_operation:-:_largest add_node:-:A add_type_node:-:_capital arg_node:-:A add_node:-:B add_edge:-:_loc arg_node:-:A arg_node:-:B add_entity_node:-:ent0:=:country arg_node:-:B end_operation:-:arg ope_for:-:A return:-:A	ent0:=:country:::usa:=:country
what is the population of ent0:=:state ?	add_node:-:B add_node:-:A add_edge:-:_population arg_node:-:B arg_node:-:A add_entity_node:-:ent0:=:state arg_node:-:B return:-:A	ent0:=:state:::new_york:=:state
what is the population of the capital of the smallest state ?	add_node:-:B add_node:-:A add_edge:-:_population arg_node:-:B arg_node:-:A add_type_node:-:_capital arg_node:-:B add_node:-:C add_edge:-:_loc arg_node:-:B arg_node:-:C add_operation:-:_smallest add_type_node:-:_state arg_node:-:C end_operation:-:arg ope_for:-:C return:-:A	
what is the area of ent0:=:state ?	add_node:-:B add_node:-:A add_edge:-:_area arg_node:-:B arg_node:-:A add_entity_node:-:ent0:=:state arg_node:-:B return:-:A	ent0:=:state:::alaska:=:state
what is the population of ent0:=:state ?	add_node:-:B add_node:-:A add_edge:-:_population arg_node:-:B arg_node:-:A add_entity_node:-:ent0:=:state arg_node:-:B return:-:A	ent0:=:state:::california:=:state
which state has the longest river ?	add_operation:-:_longest add_node:-:A add_type_node:-:_state arg_node:-:A add_node:-:B add_edge:-:_loc arg_node:-:B arg_node:-:A add_type_node:-:_river arg_node:-:B end_operation:-:arg ope_for:-:B return:-:A	
what is the capital of ent0:=:state ?	add_node:-:A add_type_node:-:_capital arg_node:-:A add_node:-:B add_edge:-:_loc arg_node:-:A arg_node:-:B add_entity_node:-:ent0:=:state arg_node:-:B return:-:A	ent0:=:state:::texas:=:state
give me the cities which are in ent0:=:state ?	add_node:-:A add_type_node:-:_city arg_node:-:A add_node:-:B add_edge:-:_loc arg_node:-:A arg_node:-:B add_entity_node:-:ent0:=:state arg_node:-:B return:-:A	ent0:=:state:::texas:=:state
what states border ent0:=:state ?	add_node:-:A add_type_node:-:_state arg_node:-:A add_node:-:B add_edge:-:_next_to arg_node:-:A arg_node:-:B add_entity_node:-:ent0:=:state arg_node:-:B return:-:A	ent0:=:state:::kentucky:=:state
how high is the highest point of ent0:=:state ?	add_node:-:B add_node:-:A add_edge:-:_elevation arg_node:-:B arg_node:-:A add_operation:-:_highest add_type_node:-:_place arg_node:-:B add_node:-:C add_edge:-:_loc arg_node:-:B arg_node:-:C add_entity_node:-:ent0:=:state arg_node:-:C end_operation:-:arg ope_for:-:B return:-:A	ent0:=:state:::florida:=:state
what are the major cities in ent0:=:state ?	add_node:-:A add_type_node:-:_major arg_node:-:A add_type_node:-:_city arg_node:-:A add_node:-:B add_edge:-:_loc arg_node:-:A arg_node:-:B add_entity_node:-:ent0:=:state arg_node:-:B return:-:A	ent0:=:state:::north_carolina:=:state
what is the highest point in the state with capital ent0:=:city ?	add_operation:-:_highest add_node:-:A add_type_node:-:_place arg_node:-:A add_node:-:B add_edge:-:_loc arg_node:-:A arg_node:-:B add_type_node:-:_state arg_node:-:B add_node:-:C add_edge:-:_loc arg_node:-:C arg_node:-:B add_type_node:-:_capital arg_node:-:C add_entity_node:-:ent0:=:city arg_node:-:C end_operation:-:arg ope_for:-:A return:-:A	ent0:=:city:::des_moines:=:city
what is the lowest point in ent0:=:state ?	add_operation:-:_lowest add_node:-:A add_type_node:-:_place arg_node:-:A add_node:-:B add_edge:-:_loc arg_node:-:A arg_node:-:B add_entity_node:-:ent0:=:state arg_node:-:B end_operation:-:arg ope_for:-:A return:-:A	ent0:=:state:::california:=:state
what is the biggest city in ent0:=:state ?	add_operation:-:_largest add_node:-:A add_type_node:-:_city arg_node:-:A add_node:-:B add_edge:-:_loc arg_node:-:A arg_node:-:B add_entity_node:-:ent0:=:state arg_node:-:B end_operation:-:arg ope_for:-:A return:-:A	ent0:=:state:::wyoming:=:state
what is the largest state bordering ent0:=:state ?	add_operation:-:_largest add_node:-:A add_type_node:-:_state arg_node:-:A add_node:-:B add_edge:-:_next_to arg_node:-:A arg_node:-:B add_entity_node:-:ent0:=:state arg_node:-:B end_operation:-:arg ope_for:-:A return:-:A	ent0:=:state:::texas:=:state
what is the smallest city in ent0:=:state ?	add_operation:-:_smallest add_node:-:A add_type_node:-:_city arg_node:-:A add_node:-:B add_edge:-:_loc arg_node:-:A arg_node:-:B add_entity_node:-:ent0:=:state arg_node:-:B end_operation:-:arg ope_for:-:A return:-:A	ent0:=:state:::hawaii:=:state
what is the area of the states ?	add_node:-:B add_node:-:A add_edge:-:_area arg_node:-:B arg_node:-:A add_type_node:-:_state arg_node:-:B return:-:A	
what is the area of ent0:=:state ?	add_node:-:B add_node:-:A add_edge:-:_area arg_node:-:B arg_node:-:A add_entity_node:-:ent0:=:state arg_node:-:B return:-:A	ent0:=:state:::idaho:=:state
what state has the most rivers running through it ?	add_operation:-:_most add_node:-:A add_type_node:-:_state arg_node:-:A add_node:-:B add_edge:-:_loc arg_node:-:B arg_node:-:A add_type_node:-:_river arg_node:-:B add_edge:-:_traverse arg_node:-:B arg_node:-:A end_operation:-:arg_count ope_for:-:A ope_for:-:B return:-:A	
what is the population of ent0:=:city ?	add_node:-:B add_node:-:A add_edge:-:_population arg_node:-:B arg_node:-:A add_entity_node:-:ent0:=:city arg_node:-:B return:-:A	ent0:=:city:::springfield_mo:=:city
what is the most populated state bordering ent0:=:state ?	add_operation:-:_largest add_node:-:A add_node:-:B add_edge:-:_population arg_node:-:A arg_node:-:B add_type_node:-:_state arg_node:-:A add_node:-:C add_edge:-:_next_to arg_node:-:A arg_node:-:C add_entity_node:-:ent0:=:state arg_node:-:C end_operation:-:arg ope_for:-:B return:-:A	ent0:=:state:::oklahoma:=:state
what is the number of neighboring states for ent0:=:state ?	add_operation:-:_count add_node:-:B add_type_node:-:_state arg_node:-:B add_node:-:C add_edge:-:_next_to arg_node:-:B arg_node:-:C add_entity_node:-:ent0:=:state arg_node:-:C end_operation:-:_count ope_for:-:B ope_return:-:A return:-:A	ent0:=:state:::kentucky:=:state
what is the average population per square km in ent0:=:state ?	add_node:-:B add_node:-:A add_edge:-:_density arg_node:-:B arg_node:-:A add_entity_node:-:ent0:=:state arg_node:-:B return:-:A	ent0:=:state:::pennsylvania:=:state
what state has the highest population density ?	add_operation:-:_largest add_node:-:A add_type_node:-:_state arg_node:-:A add_node:-:B add_edge:-:_density arg_node:-:A arg_node:-:B end_operation:-:arg ope_for:-:B return:-:A	
what is the tallest mountain in ent0:=:country ?	add_operation:-:_highest add_node:-:A add_type_node:-:_mountain arg_node:-:A add_node:-:B add_edge:-:_loc arg_node:-:A arg_node:-:B add_entity_node:-:ent0:=:country arg_node:-:B end_operation:-:arg ope_for:-:A return:-:A	ent0:=:country:::usa:=:country
what is the highest point of the state with the largest area ?	add_operation:-:_highest add_node:-:A add_type_node:-:_place arg_node:-:A add_node:-:B add_edge:-:_loc arg_node:-:A arg_node:-:B add_operation:-:_largest add_type_node:-:_state arg_node:-:B add_node:-:C add_edge:-:_area arg_node:-:B arg_node:-:C end_operation:-:arg ope_for:-:C end_operation:-:arg ope_for:-:A return:-:A	
what are the states ?	add_node:-:A add_type_node:-:_state arg_node:-:A return:-:A	
how many rivers in ent0:=:state ?	add_operation:-:_count add_node:-:B add_type_node:-:_river arg_node:-:B add_node:-:C add_edge:-:_loc arg_node:-:B arg_node:-:C add_entity_node:-:ent0:=:state arg_node:-:C end_operation:-:_count ope_for:-:B ope_return:-:A return:-:A	ent0:=:state:::washington:=:state
what are the populations of the states through which ent0:=:river run ?	add_node:-:B add_node:-:A add_edge:-:_population arg_node:-:B arg_node:-:A add_type_node:-:_state arg_node:-:B add_node:-:C add_edge:-:_traverse arg_node:-:C arg_node:-:B add_entity_node:-:ent0:=:river arg_node:-:C add_type_node:-:_river arg_node:-:C return:-:A	ent0:=:river:::mississippi:=:river
what is the biggest river in ent0:=:state ?	add_operation:-:_largest add_node:-:A add_type_node:-:_river arg_node:-:A add_node:-:B add_edge:-:_loc arg_node:-:A arg_node:-:B add_entity_node:-:ent0:=:state arg_node:-:B end_operation:-:arg ope_for:-:A return:-:A	ent0:=:state:::illinois:=:state
what is the capital of ent0:=:state ?	add_node:-:A add_type_node:-:_capital arg_node:-:A add_node:-:B add_edge:-:_loc arg_node:-:A arg_node:-:B add_entity_node:-:ent0:=:state arg_node:-:B return:-:A	ent0:=:state:::michigan:=:state
what is the total population of the states that border ent0:=:state ?	add_operation:-:_sum add_node:-:C add_type_node:-:_state arg_node:-:C add_node:-:D add_edge:-:_next_to arg_node:-:D arg_node:-:C add_entity_node:-:ent0:=:state arg_node:-:D add_type_node:-:_population arg_node:-:C end_operation:-:_sum ope_for:-:C ope_in:-:_population ope_return:-:A return:-:A	ent0:=:state:::texas:=:state
what states border ent0:=:state ?	add_node:-:A add_type_node:-:_state arg_node:-:A add_node:-:B add_edge:-:_next_to arg_node:-:A arg_node:-:B add_entity_node:-:ent0:=:state arg_node:-:B return:-:A	ent0:=:state:::rhode_island:=:state
what is the biggest city in ent0:=:state ?	add_operation:-:_largest add_node:-:A add_type_node:-:_city arg_node:-:A add_node:-:B add_edge:-:_loc arg_node:-:A arg_node:-:B add_entity_node:-:ent0:=:state arg_node:-:B end_operation:-:arg ope_for:-:A return:-:A	ent0:=:state:::oregon:=:state
what is the lowest point in ent0:=:state ?	add_operation:-:_lowest add_node:-:A add_type_node:-:_place arg_node:-:A add_node:-:B add_edge:-:_loc arg_node:-:A arg_node:-:B add_entity_node:-:ent0:=:state arg_node:-:B end_operation:-:arg ope_for:-:A return:-:A	ent0:=:state:::wisconsin:=:state
what are the rivers in the state of ent0:=:state ?	add_node:-:A add_type_node:-:_river arg_node:-:A add_node:-:B add_edge:-:_loc arg_node:-:A arg_node:-:B add_type_node:-:_state arg_node:-:B add_entity_node:-:ent0:=:state arg_node:-:B return:-:A	ent0:=:state:::indiana:=:state
what is the population of ent0:=:city ?	add_node:-:B add_node:-:A add_edge:-:_population arg_node:-:B arg_node:-:A add_entity_node:-:ent0:=:city arg_node:-:B return:-:A	ent0:=:city:::austin:=:city
what is the smallest city in ent0:=:state ?	add_operation:-:_smallest add_node:-:A add_type_node:-:_city arg_node:-:A add_node:-:B add_edge:-:_loc arg_node:-:A arg_node:-:B add_entity_node:-:ent0:=:state arg_node:-:B end_operation:-:arg ope_for:-:A return:-:A	ent0:=:state:::arkansas:=:state
give me the longest river that passes through ent0:=:country ?	add_operation:-:_longest add_node:-:A add_type_node:-:_river arg_node:-:A add_node:-:B add_edge:-:_traverse arg_node:-:A arg_node:-:B add_entity_node:-:ent0:=:country arg_node:-:B end_operation:-:arg ope_for:-:A return:-:A	ent0:=:country:::usa:=:country
how long is ent0:=:river ?	add_node:-:B add_node:-:A add_edge:-:_len arg_node:-:B arg_node:-:A add_entity_node:-:ent0:=:river arg_node:-:B add_type_node:-:_river arg_node:-:B return:-:A	ent0:=:river:::missouri:=:river
which state has the largest city ?	add_operation:-:_largest add_node:-:A add_type_node:-:_state arg_node:-:A add_node:-:B add_edge:-:_loc arg_node:-:B arg_node:-:A add_type_node:-:_city arg_node:-:B end_operation:-:arg ope_for:-:B return:-:A	
what is the lowest elevation in ent0:=:state ?	add_operation:-:_lowest add_node:-:A add_type_node:-:_place arg_node:-:A add_node:-:B add_edge:-:_loc arg_node:-:A arg_node:-:B add_entity_node:-:ent0:=:state arg_node:-:B end_operation:-:arg ope_for:-:A return:-:A	ent0:=:state:::pennsylvania:=:state
what is the longest river in the state with the highest point ?	add_operation:-:_longest add_node:-:A add_type_node:-:_river arg_node:-:A add_node:-:B add_edge:-:_loc arg_node:-:A arg_node:-:B add_type_node:-:_state arg_node:-:B add_node:-:C add_edge:-:_loc arg_node:-:C arg_node:-:B add_operation:-:_highest add_type_node:-:_place arg_node:-:C end_operation:-:arg ope_for:-:C end_operation:-:arg ope_for:-:A return:-:A	
what states does ent0:=:river run through ?	add_node:-:A add_type_node:-:_state arg_node:-:A add_node:-:B add_edge:-:_traverse arg_node:-:B arg_node:-:A add_entity_node:-:ent0:=:river arg_node:-:B add_type_node:-:_river arg_node:-:B return:-:A	ent0:=:river:::colorado:=:river
what are the states that ent0:=:river run through ?	add_node:-:A add_type_node:-:_state arg_node:-:A add_node:-:B add_edge:-:_traverse arg_node:-:B arg_node:-:A add_entity_node:-:ent0:=:river arg_node:-:B return:-:A	ent0:=:river:::potomac:=:river
what is the biggest city in ent0:=:country ?	add_operation:-:_largest add_node:-:A add_type_node:-:_city arg_node:-:A add_node:-:B add_edge:-:_loc arg_node:-:A arg_node:-:B add_entity_node:-:ent0:=:country arg_node:-:B end_operation:-:arg ope_for:-:A return:-:A	ent0:=:country:::usa:=:country
what state has no rivers ?	add_node:-:A add_type_node:-:_state arg_node:-:A add_operation:-:_not add_node:-:B add_edge:-:_loc arg_node:-:B arg_node:-:A add_type_node:-:_river arg_node:-:B end_operation:-:_not return:-:A	
what is the highest point in ent0:=:state ?	add_operation:-:_highest add_node:-:A add_type_node:-:_place arg_node:-:A add_node:-:B add_edge:-:_loc arg_node:-:A arg_node:-:B add_entity_node:-:ent0:=:state arg_node:-:B end_operation:-:arg ope_for:-:A return:-:A	ent0:=:state:::rhode_island:=:state
name the states which have no surrounding states ?	add_node:-:A add_type_node:-:_state arg_node:-:A add_operation:-:_not add_node:-:B add_edge:-:_next_to arg_node:-:A arg_node:-:B add_type_node:-:_state arg_node:-:B end_operation:-:_not return:-:A	
what is the population of ent0:=:city ?	add_node:-:B add_node:-:A add_edge:-:_population arg_node:-:B arg_node:-:A add_entity_node:-:ent0:=:city arg_node:-:B return:-:A	ent0:=:city:::atlanta:=:city
how many square kilometers in ent0:=:country ?	add_node:-:B add_node:-:A add_edge:-:_area arg_node:-:B arg_node:-:A add_entity_node:-:ent0:=:country arg_node:-:B return:-:A	ent0:=:country:::usa:=:country
what is the population of ent0:=:state ?	add_node:-:B add_node:-:A add_edge:-:_population arg_node:-:B arg_node:-:A add_entity_node:-:ent0:=:state arg_node:-:B return:-:A	ent0:=:state:::idaho:=:state
what is the adjacent state of ent0:=:state ?	add_node:-:A add_node:-:B add_edge:-:_next_to arg_node:-:A arg_node:-:B add_type_node:-:_state arg_node:-:A add_entity_node:-:ent0:=:state arg_node:-:B return:-:A	ent0:=:state:::california:=:state
what is the smallest state through which the longest river runs ?	add_operation:-:_smallest add_node:-:A add_type_node:-:_state arg_node:-:A add_node:-:B add_edge:-:_traverse arg_node:-:B arg_node:-:A add_operation:-:_longest add_type_node:-:_river arg_node:-:B end_operation:-:arg ope_for:-:B end_operation:-:arg ope_for:-:A return:-:A	
what are the names of the major cities in ent0:=:state ?	add_node:-:A add_type_node:-:_major arg_node:-:A add_type_node:-:_city arg_node:-:A add_node:-:B add_edge:-:_loc arg_node:-:A arg_node:-:B add_entity_node:-:ent0:=:state arg_node:-:B return:-:A	ent0:=:state:::illinois:=:state
how many states does ent0:=:river run through ?	add_operation:-:_count add_node:-:B add_type_node:-:_state arg_node:-:B add_node:-:C add_edge:-:_traverse arg_node:-:C arg_node:-:B add_entity_node:-:ent0:=:river arg_node:-:C add_type_node:-:_river arg_node:-:C end_operation:-:_count ope_for:-:B ope_return:-:A return:-:A	ent0:=:river:::colorado:=:river
how many states does ent0:=:river flow through ?	add_operation:-:_count add_node:-:B add_type_node:-:_state arg_node:-:B add_node:-:C add_edge:-:_traverse arg_node:-:C arg_node:-:B add_entity_node:-:ent0:=:river arg_node:-:C add_type_node:-:_river arg_node:-:C end_operation:-:_count ope_for:-:B ope_return:-:A return:-:A	ent0:=:river:::colorado:=:river
what are the major cities in ent0:=:state ?	add_node:-:A add_type_node:-:_major arg_node:-:A add_type_node:-:_city arg_node:-:A add_node:-:B add_edge:-:_loc arg_node:-:A arg_node:-:B add_entity_node:-:ent0:=:state arg_node:-:B return:-:A	ent0:=:state:::kansas:=:state
which states border ent0:=:state ?	add_node:-:A add_type_node:-:_state arg_node:-:A add_node:-:B add_edge:-:_next_to arg_node:-:A arg_node:-:B add_entity_node:-:ent0:=:state arg_node:-:B return:-:A	ent0:=:state:::texas:=:state
how many people live in ent0:=:state ?	add_node:-:B add_node:-:A add_edge:-:_population arg_node:-:B arg_node:-:A add_entity_node:-:ent0:=:state arg_node:-:B return:-:A	ent0:=:state:::new_york:=:state
what are the largest cities in the states that border the largest state ?	add_operation:-:_largest add_node:-:A add_type_node:-:_city arg_node:-:A add_node:-:B add_edge:-:_loc arg_node:-:A arg_node:-:B add_type_node:-:_state arg_node:-:B add_node:-:C add_edge:-:_next_to arg_node:-:B arg_node:-:C add_operation:-:_largest add_type_node:-:_state arg_node:-:C end_operation:-:arg ope_for:-:C end_operation:-:arg ope_for:-:A return:-:A	
which states have points that are higher than the highest point in ent0:=:state ?	add_node:-:A add_type_node:-:_state arg_node:-:A add_node:-:B add_edge:-:_loc arg_node:-:B arg_node:-:A add_node:-:C add_edge:-:_higher arg_node:-:B arg_node:-:C add_operation:-:_highest add_type_node:-:_place arg_node:-:C add_node:-:D add_edge:-:_loc arg_node:-:C arg_node:-:D add_entity_node:-:ent0:=:state arg_node:-:D end_operation:-:arg ope_for:-:C add_type_node:-:_place arg_node:-:B return:-:A	ent0:=:state:::texas:=:state
what is the river that cross over ent0:=:state ?	add_node:-:A add_type_node:-:_river arg_node:-:A add_node:-:B add_edge:-:_traverse arg_node:-:A arg_node:-:B add_entity_node:-:ent0:=:state arg_node:-:B return:-:A	ent0:=:state:::ohio:=:state
what is the largest city in ent0:=:state ?	add_operation:-:_largest add_node:-:A add_type_node:-:_city arg_node:-:A add_node:-:B add_edge:-:_loc arg_node:-:A arg_node:-:B add_entity_node:-:ent0:=:state arg_node:-:B end_operation:-:arg ope_for:-:A return:-:A	ent0:=:state:::michigan:=:state
how many rivers are in the state with the highest point ?	add_operation:-:_count add_node:-:B add_type_node:-:_river arg_node:-:B add_node:-:C add_edge:-:_loc arg_node:-:B arg_node:-:C add_type_node:-:_state arg_node:-:C add_node:-:D add_edge:-:_loc arg_node:-:D arg_node:-:C add_operation:-:_highest add_type_node:-:_place arg_node:-:D end_operation:-:arg ope_for:-:D end_operation:-:_count ope_for:-:B ope_return:-:A return:-:A	
what cities are located in ent0:=:state ?	add_node:-:A add_type_node:-:_city arg_node:-:A add_node:-:B add_edge:-:_loc arg_node:-:A arg_node:-:B add_entity_node:-:ent0:=:state arg_node:-:B return:-:A	ent0:=:state:::pennsylvania:=:state
what is the state with the lowest population ?	add_operation:-:_smallest add_node:-:A add_type_node:-:_state arg_node:-:A add_node:-:B add_edge:-:_population arg_node:-:A arg_node:-:B end_operation:-:arg ope_for:-:B return:-:A	
what is the highest point in each state whose lowest point is sea level ?	add_node:-:B add_node:-:A add_edge:-:_high_point arg_node:-:B arg_node:-:A add_type_node:-:_state arg_node:-:B add_node:-:C add_edge:-:_low_point arg_node:-:B arg_node:-:C add_type_node:-:_elevation arg_node:-:C return:-:A	
give me the cities in ent0:=:country ?	add_node:-:A add_type_node:-:_city arg_node:-:A add_node:-:B add_edge:-:_loc arg_node:-:A arg_node:-:B add_entity_node:-:ent0:=:country arg_node:-:B return:-:A	ent0:=:country:::usa:=:country
how many states does ent0:=:river run through ?	add_operation:-:_count add_node:-:B add_type_node:-:_state arg_node:-:B add_node:-:C add_edge:-:_traverse arg_node:-:C arg_node:-:B add_entity_node:-:ent0:=:river arg_node:-:C add_type_node:-:_river arg_node:-:C end_operation:-:_count ope_for:-:B ope_return:-:A return:-:A	ent0:=:river:::missouri:=:river
what state has the city with the largest population ?	add_node:-:A add_type_node:-:_state arg_node:-:A add_node:-:B add_edge:-:_loc arg_node:-:B arg_node:-:A add_operation:-:_largest add_type_node:-:_city arg_node:-:B add_node:-:C add_edge:-:_population arg_node:-:B arg_node:-:C end_operation:-:arg ope_for:-:C return:-:A	
which is the shortest river ?	add_operation:-:_shortest add_node:-:A add_type_node:-:_river arg_node:-:A end_operation:-:arg ope_for:-:A return:-:A	
how many states border ent0:=:state ?	add_operation:-:_count add_node:-:B add_type_node:-:_state arg_node:-:B add_node:-:C add_edge:-:_next_to arg_node:-:B arg_node:-:C add_entity_node:-:ent0:=:state arg_node:-:C end_operation:-:_count ope_for:-:B ope_return:-:A return:-:A	ent0:=:state:::alaska:=:state
what is the population of ent0:=:city ?	add_node:-:B add_node:-:A add_edge:-:_population arg_node:-:B arg_node:-:A add_entity_node:-:ent0:=:city arg_node:-:B return:-:A	ent0:=:city:::dallas:=:city
where is ent0:=:city ?	add_node:-:B add_node:-:A add_edge:-:_loc arg_node:-:B arg_node:-:A add_entity_node:-:ent0:=:city arg_node:-:B return:-:A	ent0:=:city:::san_jose:=:city
what states border states that border ent0:=:state ?	add_node:-:A add_type_node:-:_state arg_node:-:A add_node:-:B add_edge:-:_next_to arg_node:-:A arg_node:-:B add_type_node:-:_state arg_node:-:B add_node:-:C add_edge:-:_next_to arg_node:-:B arg_node:-:C add_entity_node:-:ent0:=:state arg_node:-:C return:-:A	ent0:=:state:::colorado:=:state
what rivers flow through the state with the largest population ?	add_node:-:A add_type_node:-:_river arg_node:-:A add_node:-:B add_edge:-:_traverse arg_node:-:A arg_node:-:B add_operation:-:_largest add_type_node:-:_state arg_node:-:B add_node:-:C add_edge:-:_population arg_node:-:B arg_node:-:C end_operation:-:arg ope_for:-:C return:-:A	
whats the largest city ?	add_operation:-:_largest add_node:-:A add_type_node:-:_city arg_node:-:A end_operation:-:arg ope_for:-:A return:-:A	
what is the capital of ent0:=:state ?	add_node:-:A add_type_node:-:_capital arg_node:-:A add_node:-:B add_edge:-:_loc arg_node:-:A arg_node:-:B add_entity_node:-:ent0:=:state arg_node:-:B add_type_node:-:_state arg_node:-:B return:-:A	ent0:=:state:::alabama:=:state
what states border ent0:=:state ?	add_node:-:A add_type_node:-:_state arg_node:-:A add_node:-:B add_edge:-:_next_to arg_node:-:A arg_node:-:B add_entity_node:-:ent0:=:state arg_node:-:B return:-:A	ent0:=:state:::arkansas:=:state
what is the population of ent0:=:city ?	add_node:-:B add_node:-:A add_edge:-:_population arg_node:-:B arg_node:-:A add_entity_node:-:ent0:=:city arg_node:-:B return:-:A	ent0:=:city:::denver:=:city
what is the longest river in ent0:=:country ?	add_operation:-:_longest add_node:-:A add_type_node:-:_river arg_node:-:A add_node:-:B add_edge:-:_loc arg_node:-:A arg_node:-:B add_entity_node:-:ent0:=:country arg_node:-:B end_operation:-:arg ope_for:-:A return:-:A	ent0:=:country:::usa:=:country
where is ent0:=:state ?	add_node:-:B add_node:-:A add_edge:-:_loc arg_node:-:B arg_node:-:A add_entity_node:-:ent0:=:state arg_node:-:B return:-:A	ent0:=:state:::massachusetts:=:state
what state has the smallest area ?	add_operation:-:_smallest add_node:-:A add_type_node:-:_state arg_node:-:A add_node:-:B add_edge:-:_area arg_node:-:A arg_node:-:B end_operation:-:arg ope_for:-:B return:-:A	
what major rivers run through ent0:=:state ?	add_node:-:A add_type_node:-:_major arg_node:-:A add_type_node:-:_river arg_node:-:A add_node:-:B add_edge:-:_traverse arg_node:-:A arg_node:-:B add_entity_node:-:ent0:=:state arg_node:-:B return:-:A	ent0:=:state:::illinois:=:state
how many cities does ent0:=:country have ?	add_operation:-:_count add_node:-:B add_type_node:-:_city arg_node:-:B add_node:-:C add_edge:-:_loc arg_node:-:B arg_node:-:C add_entity_node:-:ent0:=:country arg_node:-:C end_operation:-:_count ope_for:-:B ope_return:-:A return:-:A	ent0:=:country:::usa:=:country
how many people live in ent0:=:state ?	add_node:-:B add_node:-:A add_edge:-:_population arg_node:-:B arg_node:-:A add_entity_node:-:ent0:=:state arg_node:-:B return:-:A	ent0:=:state:::california:=:state
what are the major rivers in ent0:=:country ?	add_node:-:A add_type_node:-:_major arg_node:-:A add_type_node:-:_river arg_node:-:A add_node:-:B add_edge:-:_loc arg_node:-:A arg_node:-:B add_entity_node:-:ent0:=:country arg_node:-:B return:-:A	ent0:=:country:::usa:=:country
how many states does ent0:=:river run through ?	add_operation:-:_count add_node:-:B add_type_node:-:_state arg_node:-:B add_node:-:C add_edge:-:_traverse arg_node:-:C arg_node:-:B add_entity_node:-:ent0:=:river arg_node:-:C add_type_node:-:_river arg_node:-:C end_operation:-:_count ope_for:-:B ope_return:-:A return:-:A	ent0:=:river:::mississippi:=:river
what is the area of ent0:=:state ?	add_node:-:B add_node:-:A add_edge:-:_area arg_node:-:B arg_node:-:A add_entity_node:-:ent0:=:state arg_node:-:B return:-:A	ent0:=:state:::texas:=:state
what is the length of the river that traverses the most states ?	add_node:-:B add_node:-:A add_edge:-:_len arg_node:-:B arg_node:-:A add_operation:-:_most add_type_node:-:_river arg_node:-:B add_node:-:C add_edge:-:_traverse arg_node:-:B arg_node:-:C add_type_node:-:_state arg_node:-:C end_operation:-:arg_count ope_for:-:B ope_for:-:C return:-:A	
what is the length of the longest river in ent0:=:country ?	add_node:-:B add_node:-:A add_edge:-:_len arg_node:-:B arg_node:-:A add_operation:-:_longest add_type_node:-:_river arg_node:-:B add_node:-:C add_edge:-:_loc arg_node:-:B arg_node:-:C add_entity_node:-:ent0:=:country arg_node:-:C end_operation:-:arg ope_for:-:B return:-:A	ent0:=:country:::usa:=:country
can you tell me the capital of ent0:=:state ?	add_node:-:A add_type_node:-:_capital arg_node:-:A add_node:-:B add_edge:-:_loc arg_node:-:A arg_node:-:B add_entity_node:-:ent0:=:state arg_node:-:B return:-:A	ent0:=:state:::texas:=:state
what is the largest city in ent0:=:state by population ?	add_operation:-:_largest add_node:-:A add_type_node:-:_city arg_node:-:A add_node:-:C add_edge:-:_loc arg_node:-:A arg_node:-:C add_entity_node:-:ent0:=:state arg_node:-:C add_node:-:B add_edge:-:_population arg_node:-:A arg_node:-:B end_operation:-:arg ope_for:-:B return:-:A	ent0:=:state:::minnesota:=:state
what is the smallest state in ent0:=:country ?	add_operation:-:_smallest add_node:-:A add_type_node:-:_state arg_node:-:A add_node:-:B add_edge:-:_loc arg_node:-:A arg_node:-:B add_entity_node:-:ent0:=:country arg_node:-:B end_operation:-:arg ope_for:-:A return:-:A	ent0:=:country:::usa:=:country
what states neighbor ent0:=:state ?	add_node:-:A add_type_node:-:_state arg_node:-:A add_node:-:B add_edge:-:_next_to arg_node:-:A arg_node:-:B add_entity_node:-:ent0:=:state arg_node:-:B return:-:A	ent0:=:state:::maine:=:state
what states high point are higher than that of ent0:=:state ?	add_node:-:A add_type_node:-:_state arg_node:-:A add_node:-:B add_edge:-:_high_point arg_node:-:A arg_node:-:B add_node:-:C add_edge:-:_higher arg_node:-:B arg_node:-:C add_node:-:D add_edge:-:_high_point arg_node:-:D arg_node:-:C add_entity_node:-:ent0:=:state arg_node:-:D return:-:A	ent0:=:state:::colorado:=:state
what is the highest mountain in ent0:=:state ?	add_operation:-:_highest add_node:-:A add_type_node:-:_mountain arg_node:-:A add_node:-:B add_edge:-:_loc arg_node:-:A arg_node:-:B add_entity_node:-:ent0:=:state arg_node:-:B end_operation:-:arg ope_for:-:A return:-:A	ent0:=:state:::texas:=:state
what are the major cities in ent0:=:state ?	add_node:-:A add_type_node:-:_major arg_node:-:A add_type_node:-:_city arg_node:-:A add_node:-:B add_edge:-:_loc arg_node:-:A arg_node:-:B add_entity_node:-:ent0:=:state arg_node:-:B return:-:A	ent0:=:state:::texas:=:state
what are the states that border the state with the greatest population ?	add_node:-:A add_type_node:-:_state arg_node:-:A add_node:-:B add_edge:-:_next_to arg_node:-:B arg_node:-:A add_operation:-:_largest add_type_node:-:_state arg_node:-:B add_node:-:C add_edge:-:_population arg_node:-:B arg_node:-:C end_operation:-:arg ope_for:-:C return:-:A	
what rivers run through ent0:=:state ?	add_node:-:A add_type_node:-:_river arg_node:-:A add_node:-:B add_edge:-:_traverse arg_node:-:A arg_node:-:B add_entity_node:-:ent0:=:state arg_node:-:B return:-:A	ent0:=:state:::colorado:=:state
how many rivers are there in ent0:=:country ?	add_operation:-:_count add_node:-:B add_type_node:-:_river arg_node:-:B add_node:-:C add_edge:-:_loc arg_node:-:B arg_node:-:C add_entity_node:-:ent0:=:country arg_node:-:C end_operation:-:_count ope_for:-:B ope_return:-:A return:-:A	ent0:=:country:::usa:=:country
how many rivers are in ent0:=:state ?	add_operation:-:_count add_node:-:B add_type_node:-:_river arg_node:-:B add_node:-:C add_edge:-:_loc arg_node:-:B arg_node:-:C add_entity_node:-:ent0:=:state arg_node:-:C end_operation:-:_count ope_for:-:B ope_return:-:A return:-:A	ent0:=:state:::new_york:=:state
which rivers are in ent0:=:state ?	add_node:-:A add_type_node:-:_river arg_node:-:A add_node:-:B add_edge:-:_loc arg_node:-:A arg_node:-:B add_entity_node:-:ent0:=:state arg_node:-:B return:-:A	ent0:=:state:::alaska:=:state
what is the longest river flowing through ent0:=:state ?	add_operation:-:_longest add_node:-:A add_type_node:-:_river arg_node:-:A add_node:-:B add_edge:-:_traverse arg_node:-:A arg_node:-:B add_entity_node:-:ent0:=:state arg_node:-:B end_operation:-:arg ope_for:-:A return:-:A	ent0:=:state:::new_york:=:state
what rivers run through ent0:=:state ?	add_node:-:A add_type_node:-:_river arg_node:-:A add_node:-:B add_edge:-:_traverse arg_node:-:A arg_node:-:B add_entity_node:-:ent0:=:state arg_node:-:B return:-:A	ent0:=:state:::west_virginia:=:state
what are the capitals of the states that border ent0:=:state ?	add_node:-:A add_type_node:-:_capital arg_node:-:A add_node:-:B add_edge:-:_loc arg_node:-:A arg_node:-:B add_type_node:-:_state arg_node:-:B add_node:-:C add_edge:-:_next_to arg_node:-:B arg_node:-:C add_entity_node:-:ent0:=:state arg_node:-:C return:-:A	ent0:=:state:::texas:=:state
what is the area of ent0:=:state ?	add_node:-:B add_node:-:A add_edge:-:_area arg_node:-:B arg_node:-:A add_entity_node:-:ent0:=:state arg_node:-:B return:-:A	ent0:=:state:::california:=:state
how many states have a city named ent0:=:city ?	add_operation:-:_count add_node:-:B add_type_node:-:_state arg_node:-:B add_node:-:C add_edge:-:_loc arg_node:-:C arg_node:-:B add_entity_node:-:ent0:=:city arg_node:-:C end_operation:-:_count ope_for:-:B ope_return:-:A return:-:A	ent0:=:city:::springfield:=:city
what is the biggest city in ent0:=:state ?	add_operation:-:_largest add_node:-:A add_type_node:-:_city arg_node:-:A add_node:-:B add_edge:-:_loc arg_node:-:A arg_node:-:B add_entity_node:-:ent0:=:state arg_node:-:B end_operation:-:arg ope_for:-:A return:-:A	ent0:=:state:::texas:=:state
how many cities named ent0:=:city are there in ent0:=:country ?	add_operation:-:_count add_node:-:B add_type_node:-:_city arg_node:-:B add_entity_node:-:ent0:=:city arg_node:-:B add_node:-:C add_edge:-:_loc arg_node:-:B arg_node:-:C add_entity_node:-:ent0:=:country arg_node:-:C end_operation:-:_count ope_for:-:B ope_return:-:A return:-:A	ent0:=:city:::austin:=:city ent0:=:country:::usa:=:country
what are the major cities in the largest state ?	add_node:-:A add_type_node:-:_major arg_node:-:A add_type_node:-:_city arg_node:-:A add_node:-:B add_edge:-:_loc arg_node:-:A arg_node:-:B add_operation:-:_largest add_type_node:-:_state arg_node:-:B end_operation:-:arg ope_for:-:B return:-:A	
which states does ent0:=:river run through ?	add_node:-:A add_type_node:-:_state arg_node:-:A add_node:-:B add_edge:-:_traverse arg_node:-:B arg_node:-:A add_entity_node:-:ent0:=:river arg_node:-:B return:-:A	ent0:=:river:::colorado:=:river
what is the largest city in ent0:=:state ?	add_operation:-:_largest add_node:-:A add_type_node:-:_city arg_node:-:A add_node:-:B add_edge:-:_loc arg_node:-:A arg_node:-:B add_entity_node:-:ent0:=:state arg_node:-:B end_operation:-:arg ope_for:-:A return:-:A	ent0:=:state:::wisconsin:=:state
how big is ent0:=:state ?	add_node:-:B add_node:-:A add_edge:-:_size arg_node:-:B arg_node:-:A add_entity_node:-:ent0:=:state arg_node:-:B return:-:A	ent0:=:state:::alaska:=:state
what state contains the highest point in ent0:=:country ?	add_node:-:A add_type_node:-:_state arg_node:-:A add_node:-:B add_edge:-:_loc arg_node:-:B arg_node:-:A add_operation:-:_highest add_type_node:-:_place arg_node:-:B add_node:-:C add_edge:-:_loc arg_node:-:B arg_node:-:C add_entity_node:-:ent0:=:country arg_node:-:C end_operation:-:arg ope_for:-:B return:-:A	ent0:=:country:::usa:=:country
how big is ent0:=:state ?	add_node:-:B add_node:-:A add_edge:-:_size arg_node:-:B arg_node:-:A add_entity_node:-:ent0:=:state arg_node:-:B return:-:A	ent0:=:state:::north_dakota:=:state
which rivers flow through ent0:=:state ?	add_node:-:A add_type_node:-:_river arg_node:-:A add_node:-:B add_edge:-:_traverse arg_node:-:A arg_node:-:B add_entity_node:-:ent0:=:state arg_node:-:B return:-:A	ent0:=:state:::alaska:=:state
what is the highest point in ent0:=:country ?	add_operation:-:_highest add_node:-:A add_type_node:-:_place arg_node:-:A add_node:-:B add_edge:-:_loc arg_node:-:A arg_node:-:B add_entity_node:-:ent0:=:country arg_node:-:B end_operation:-:arg ope_for:-:A return:-:A	ent0:=:country:::usa:=:country
what is the shortest river in ent0:=:state ?	add_operation:-:_shortest add_node:-:A add_type_node:-:_river arg_node:-:A add_node:-:B add_edge:-:_loc arg_node:-:A arg_node:-:B add_entity_node:-:ent0:=:state arg_node:-:B end_operation:-:arg ope_for:-:A return:-:A	ent0:=:state:::texas:=:state
what are the major cities in the states through which the major river in ent0:=:state runs ?	add_node:-:A add_type_node:-:_major arg_node:-:A add_type_node:-:_city arg_node:-:A add_node:-:B add_edge:-:_loc arg_node:-:A arg_node:-:B add_type_node:-:_state arg_node:-:B add_node:-:C add_edge:-:_traverse arg_node:-:C arg_node:-:B add_type_node:-:_river arg_node:-:C add_node:-:D add_edge:-:_loc arg_node:-:C arg_node:-:D add_entity_node:-:ent0:=:state arg_node:-:D return:-:A	ent0:=:state:::virginia:=:state
what rivers are in ent0:=:state ?	add_node:-:A add_type_node:-:_river arg_node:-:A add_node:-:B add_edge:-:_loc arg_node:-:A arg_node:-:B add_entity_node:-:ent0:=:state arg_node:-:B return:-:A	ent0:=:state:::oregon:=:state
what is the lowest point in ent0:=:country ?	add_operation:-:_lowest add_node:-:A add_type_node:-:_place arg_node:-:A add_node:-:B add_edge:-:_loc arg_node:-:A arg_node:-:B add_entity_node:-:ent0:=:country arg_node:-:B end_operation:-:arg ope_for:-:A return:-:A	ent0:=:country:::usa:=:country
how many states have cities or towns named ent0:=:city ?	add_operation:-:_count add_node:-:B add_type_node:-:_state arg_node:-:B add_node:-:C add_edge:-:_loc arg_node:-:C arg_node:-:B add_type_node:-:_city arg_node:-:C add_entity_node:-:ent0:=:city arg_node:-:C end_operation:-:_count ope_for:-:B ope_return:-:A return:-:A	ent0:=:city:::springfield:=:city
what is the population of ent0:=:state ?	add_node:-:B add_node:-:A add_edge:-:_population arg_node:-:B arg_node:-:A add_entity_node:-:ent0:=:state arg_node:-:B return:-:A	ent0:=:state:::south_dakota:=:state
what is the capital of the state with the highest point ?	add_node:-:A add_type_node:-:_capital arg_node:-:A add_node:-:B add_edge:-:_loc arg_node:-:A arg_node:-:B add_operation:-:_highest add_type_node:-:_state arg_node:-:B add_node:-:C add_edge:-:_loc arg_node:-:C arg_node:-:B add_type_node:-:_place arg_node:-:C end_operation:-:arg ope_for:-:C return:-:A	
what state has the highest elevation ?	add_operation:-:_highest add_node:-:A add_type_node:-:_state arg_node:-:A add_node:-:B add_edge:-:_loc arg_node:-:B arg_node:-:A add_type_node:-:_place arg_node:-:B end_operation:-:arg ope_for:-:B return:-:A	
what states are next to ent0:=:state ?	add_node:-:A add_type_node:-:_state arg_node:-:A add_node:-:B add_edge:-:_next_to arg_node:-:A arg_node:-:B add_entity_node:-:ent0:=:state arg_node:-:B return:-:A	ent0:=:state:::texas:=:state
what is the longest river that passes the states that border the state that borders the most states ?	add_operation:-:_longest add_node:-:A add_type_node:-:_river arg_node:-:A add_node:-:B add_edge:-:_traverse arg_node:-:A arg_node:-:B add_type_node:-:_state arg_node:-:B add_node:-:C add_edge:-:_next_to arg_node:-:B arg_node:-:C add_operation:-:_most add_type_node:-:_state arg_node:-:C add_node:-:D add_edge:-:_next_to arg_node:-:C arg_node:-:D add_type_node:-:_state arg_node:-:D end_operation:-:arg_count ope_for:-:C ope_for:-:D end_operation:-:arg ope_for:-:A return:-:A	
which states border ent0:=:state ?	add_node:-:A add_type_node:-:_state arg_node:-:A add_node:-:B add_edge:-:_next_to arg_node:-:A arg_node:-:B add_entity_node:-:ent0:=:state arg_node:-:B return:-:A	ent0:=:state:::hawaii:=:state
how many major cities are there in ent0:=:state ?	add_operation:-:_count add_node:-:B add_type_node:-:_major arg_node:-:B add_type_node:-:_city arg_node:-:B add_node:-:C add_edge:-:_loc arg_node:-:B arg_node:-:C add_entity_node:-:ent0:=:state arg_node:-:C end_operation:-:_count ope_for:-:B ope_return:-:A return:-:A	ent0:=:state:::oregon:=:state
what is the population of ent0:=:city ?	add_node:-:B add_node:-:A add_edge:-:_population arg_node:-:B arg_node:-:A add_entity_node:-:ent0:=:city arg_node:-:B return:-:A	ent0:=:city:::springfield_sd:=:city
how many rivers run through ent0:=:state ?	add_operation:-:_count add_node:-:B add_type_node:-:_river arg_node:-:B add_node:-:C add_edge:-:_traverse arg_node:-:B arg_node:-:C add_entity_node:-:ent0:=:state arg_node:-:C end_operation:-:_count ope_for:-:B ope_return:-:A return:-:A	ent0:=:state:::texas:=:state
what state has the most major rivers running through it ?	add_operation:-:_most add_node:-:A add_type_node:-:_state arg_node:-:A add_node:-:B add_edge:-:_loc arg_node:-:B arg_node:-:A add_type_node:-:_major arg_node:-:B add_type_node:-:_river arg_node:-:B add_edge:-:_traverse arg_node:-:B arg_node:-:A end_operation:-:arg_count ope_for:-:A ope_for:-:B return:-:A	
what are the lakes in states bordering ent0:=:state ?	add_node:-:A add_type_node:-:_lake arg_node:-:A add_node:-:B add_edge:-:_loc arg_node:-:A arg_node:-:B add_type_node:-:_state arg_node:-:B add_node:-:C add_edge:-:_next_to arg_node:-:B arg_node:-:C add_entity_node:-:ent0:=:state arg_node:-:C return:-:A	ent0:=:state:::texas:=:state
people in ent0:=:city ?	add_node:-:B add_node:-:A add_edge:-:_population arg_node:-:B arg_node:-:A add_entity_node:-:ent0:=:city arg_node:-:B return:-:A	ent0:=:city:::boulder:=:city
what rivers are in ent0:=:state ?	add_node:-:A add_type_node:-:_river arg_node:-:A add_node:-:B add_edge:-:_loc arg_node:-:A arg_node:-:B add_entity_node:-:ent0:=:state arg_node:-:B return:-:A	ent0:=:state:::nevada:=:state
where is ent0:=:city ?	add_node:-:B add_node:-:A add_edge:-:_loc arg_node:-:B arg_node:-:A add_entity_node:-:ent0:=:city arg_node:-:B return:-:A	ent0:=:city:::fort_wayne:=:city
where is ent0:=:city ?	add_node:-:B add_node:-:A add_edge:-:_loc arg_node:-:B arg_node:-:A add_entity_node:-:ent0:=:city arg_node:-:B return:-:A	ent0:=:city:::indianapolis:=:city
what states border states that border states that border states that border ent0:=:state ?	add_node:-:A add_type_node:-:_state arg_node:-:A add_node:-:B add_edge:-:_next_to arg_node:-:A arg_node:-:B add_type_node:-:_state arg_node:-:B add_node:-:C add_edge:-:_next_to arg_node:-:B arg_node:-:C add_type_node:-:_state arg_node:-:C add_node:-:D add_edge:-:_next_to arg_node:-:C arg_node:-:D add_type_node:-:_state arg_node:-:D add_node:-:E add_edge:-:_next_to arg_node:-:D arg_node:-:E add_entity_node:-:ent0:=:state arg_node:-:E return:-:A	ent0:=:state:::texas:=:state
population of ent0:=:city ?	add_node:-:B add_node:-:A add_edge:-:_population arg_node:-:B arg_node:-:A add_entity_node:-:ent0:=:city arg_node:-:B return:-:A	ent0:=:city:::boulder:=:city
what are the major cities of ent0:=:country ?	add_node:-:A add_type_node:-:_major arg_node:-:A add_type_node:-:_city arg_node:-:A add_node:-:B add_edge:-:_loc arg_node:-:A arg_node:-:B add_entity_node:-:ent0:=:country arg_node:-:B return:-:A	ent0:=:country:::usa:=:country
show major cities in ent0:=:state ?	add_node:-:A add_type_node:-:_major arg_node:-:A add_type_node:-:_city arg_node:-:A add_node:-:B add_edge:-:_loc arg_node:-:A arg_node:-:B add_entity_node:-:ent0:=:state arg_node:-:B return:-:A	ent0:=:state:::colorado:=:state
what state is ent0:=:city the capital of ?	add_node:-:A add_type_node:-:_state arg_node:-:A add_node:-:B add_edge:-:_loc arg_node:-:B arg_node:-:A add_entity_node:-:ent0:=:city arg_node:-:B add_type_node:-:_capital arg_node:-:B return:-:A	ent0:=:city:::columbus:=:city
what is the area of all the states combined ?	add_operation:-:_sum add_node:-:C add_type_node:-:_state arg_node:-:C add_type_node:-:_area arg_node:-:C end_operation:-:_sum ope_for:-:C ope_in:-:_area ope_return:-:A return:-:A	
what is the average population per square km in ent0:=:country ?	add_node:-:B add_node:-:A add_edge:-:_density arg_node:-:B arg_node:-:A add_entity_node:-:ent0:=:country arg_node:-:B return:-:A	ent0:=:country:::usa:=:country
what is the largest state that borders ent0:=:state ?	add_operation:-:_largest add_node:-:A add_type_node:-:_state arg_node:-:A add_node:-:B add_edge:-:_next_to arg_node:-:A arg_node:-:B add_entity_node:-:ent0:=:state arg_node:-:B end_operation:-:arg ope_for:-:A return:-:A	ent0:=:state:::california:=:state
what is the population of ent0:=:state ?	add_node:-:B add_node:-:A add_edge:-:_population arg_node:-:B arg_node:-:A add_entity_node:-:ent0:=:state arg_node:-:B return:-:A	ent0:=:state:::montana:=:state
what are the populations of all the major cities in ent0:=:state ?	add_node:-:B add_node:-:A add_edge:-:_population arg_node:-:B arg_node:-:A add_type_node:-:_major arg_node:-:B add_type_node:-:_city arg_node:-:B add_node:-:C add_edge:-:_loc arg_node:-:B arg_node:-:C add_entity_node:-:ent0:=:state arg_node:-:C return:-:A	ent0:=:state:::montana:=:state
which rivers run through the state with the lowest elevation in ent0:=:country ?	add_node:-:A add_type_node:-:_river arg_node:-:A add_node:-:B add_edge:-:_traverse arg_node:-:A arg_node:-:B add_type_node:-:_state arg_node:-:B add_node:-:C add_edge:-:_loc arg_node:-:C arg_node:-:B add_operation:-:_lowest add_type_node:-:_place arg_node:-:C add_node:-:D add_edge:-:_loc arg_node:-:C arg_node:-:D add_entity_node:-:ent0:=:country arg_node:-:D end_operation:-:arg ope_for:-:C return:-:A	ent0:=:country:::usa:=:country
what rivers flow through the largest state ?	add_node:-:A add_type_node:-:_river arg_node:-:A add_node:-:B add_edge:-:_traverse arg_node:-:A arg_node:-:B add_operation:-:_largest add_type_node:-:_state arg_node:-:B end_operation:-:arg ope_for:-:B return:-:A	
what is the area of ent0:=:state ?	add_node:-:B add_node:-:A add_edge:-:_area arg_node:-:B arg_node:-:A add_entity_node:-:ent0:=:state arg_node:-:B return:-:A	ent0:=:state:::maine:=:state
what are major rivers in ent0:=:state ?	add_node:-:A add_type_node:-:_major arg_node:-:A add_type_node:-:_river arg_node:-:A add_node:-:B add_edge:-:_loc arg_node:-:A arg_node:-:B add_entity_node:-:ent0:=:state arg_node:-:B return:-:A	ent0:=:state:::texas:=:state
what is the population density of the state with the smallest population ?	add_node:-:B add_node:-:A add_edge:-:_density arg_node:-:B arg_node:-:A add_operation:-:_smallest add_type_node:-:_state arg_node:-:B add_node:-:C add_edge:-:_population arg_node:-:B arg_node:-:C end_operation:-:arg ope_for:-:C return:-:A	
what is the highest point in ent0:=:state ?	add_operation:-:_highest add_node:-:A add_type_node:-:_place arg_node:-:A add_node:-:B add_edge:-:_loc arg_node:-:A arg_node:-:B add_entity_node:-:ent0:=:state arg_node:-:B end_operation:-:arg ope_for:-:A return:-:A	ent0:=:state:::wyoming:=:state
what states border ent0:=:state ?	add_node:-:A add_type_node:-:_state arg_node:-:A add_node:-:B add_edge:-:_next_to arg_node:-:A arg_node:-:B add_entity_node:-:ent0:=:state arg_node:-:B return:-:A	ent0:=:state:::delaware:=:state
which state has the most rivers running through it ?	add_operation:-:_most add_node:-:A add_type_node:-:_state arg_node:-:A add_node:-:B add_edge:-:_loc arg_node:-:B arg_node:-:A add_type_node:-:_river arg_node:-:B add_edge:-:_traverse arg_node:-:B arg_node:-:A end_operation:-:arg_count ope_for:-:A ope_for:-:B return:-:A	
what is largest capital ?	add_operation:-:_largest add_node:-:A add_type_node:-:_capital arg_node:-:A end_operation:-:arg ope_for:-:A return:-:A	
what is the state with the largest population density ?	add_operation:-:_largest add_node:-:A add_type_node:-:_state arg_node:-:A add_node:-:B add_edge:-:_density arg_node:-:A arg_node:-:B end_operation:-:arg ope_for:-:B return:-:A	
what states have towns named ent0:=:city ?	add_node:-:A add_type_node:-:_state arg_node:-:A add_node:-:B add_edge:-:_loc arg_node:-:B arg_node:-:A add_entity_node:-:ent0:=:city arg_node:-:B return:-:A	ent0:=:city:::springfield:=:city
what is the smallest city in the largest state ?	add_operation:-:_smallest add_node:-:A add_type_node:-:_city arg_node:-:A add_node:-:B add_edge:-:_loc arg_node:-:A arg_node:-:B add_operation:-:_largest add_type_node:-:_state arg_node:-:B end_operation:-:arg ope_for:-:B end_operation:-:arg ope_for:-:A return:-:A	
what mountains are in ent0:=:state ?	add_node:-:A add_type_node:-:_mountain arg_node:-:A add_node:-:B add_edge:-:_loc arg_node:-:A arg_node:-:B add_entity_node:-:ent0:=:state arg_node:-:B return:-:A	ent0:=:state:::alaska:=:state
what rivers flow through ent0:=:state ?	add_node:-:A add_type_node:-:_river arg_node:-:A add_node:-:B add_edge:-:_traverse arg_node:-:A arg_node:-:B add_entity_node:-:ent0:=:state arg_node:-:B return:-:A	ent0:=:state:::colorado:=:state
which state has the least population density ?	add_operation:-:_smallest add_node:-:A add_type_node:-:_state arg_node:-:A add_node:-:B add_edge:-:_density arg_node:-:A arg_node:-:B end_operation:-:arg ope_for:-:B return:-:A	
how many inhabitants does ent0:=:city have ?	add_node:-:B add_node:-:A add_edge:-:_population arg_node:-:B arg_node:-:A add_entity_node:-:ent0:=:city arg_node:-:B return:-:A	ent0:=:city:::montgomery:=:city
what city has the largest population ?	add_operation:-:_largest add_node:-:A add_type_node:-:_city arg_node:-:A add_node:-:B add_edge:-:_population arg_node:-:A arg_node:-:B end_operation:-:arg ope_for:-:B return:-:A	
what is the largest state ?	add_operation:-:_largest add_node:-:A add_type_node:-:_state arg_node:-:A end_operation:-:arg ope_for:-:A return:-:A	
of the states washed by ent0:=:river which has the lowest point ?	add_operation:-:_lowest add_node:-:A add_type_node:-:_state arg_node:-:A add_node:-:C add_edge:-:_traverse arg_node:-:C arg_node:-:A add_entity_node:-:ent0:=:river arg_node:-:C add_node:-:B add_edge:-:_loc arg_node:-:B arg_node:-:A add_type_node:-:_place arg_node:-:B end_operation:-:arg ope_for:-:B return:-:A	ent0:=:river:::mississippi:=:river
what is the area of the state with the smallest population density ?	add_node:-:B add_node:-:A add_edge:-:_area arg_node:-:B arg_node:-:A add_operation:-:_smallest add_type_node:-:_state arg_node:-:B add_node:-:C add_edge:-:_density arg_node:-:B arg_node:-:C end_operation:-:arg ope_for:-:C return:-:A	
which state contains most rivers ?	add_operation:-:_most add_node:-:A add_type_node:-:_state arg_node:-:A add_node:-:B add_edge:-:_loc arg_node:-:B arg_node:-:A add_type_node:-:_river arg_node:-:B end_operation:-:arg_count ope_for:-:A ope_for:-:B return:-:A	
what is the longest river in ent0:=:state ?	add_operation:-:_longest add_node:-:A add_type_node:-:_river arg_node:-:A add_node:-:B add_edge:-:_loc arg_node:-:A arg_node:-:B add_entity_node:-:ent0:=:state arg_node:-:B end_operation:-:arg ope_for:-:A return:-:A	ent0:=:state:::mississippi:=:state
what is the capital of the largest state ?	add_node:-:A add_type_node:-:_capital arg_node:-:A add_node:-:B add_edge:-:_loc arg_node:-:A arg_node:-:B add_operation:-:_largest add_type_node:-:_state arg_node:-:B end_operation:-:arg ope_for:-:B return:-:A	
what state has the largest population ?	add_operation:-:_largest add_node:-:A add_type_node:-:_state arg_node:-:A add_node:-:B add_edge:-:_population arg_node:-:A arg_node:-:B end_operation:-:arg ope_for:-:B return:-:A	
name the rivers in ent0:=:state ?	add_node:-:A add_type_node:-:_river arg_node:-:A add_node:-:B add_edge:-:_loc arg_node:-:A arg_node:-:B add_entity_node:-:ent0:=:state arg_node:-:B return:-:A	ent0:=:state:::arkansas:=:state
what are the populations of states through which ent0:=:river run ?	add_node:-:B add_node:-:A add_edge:-:_population arg_node:-:B arg_node:-:A add_type_node:-:_state arg_node:-:B add_node:-:C add_edge:-:_traverse arg_node:-:C arg_node:-:B add_entity_node:-:ent0:=:river arg_node:-:C return:-:A	ent0:=:river:::mississippi:=:river
what is the population of ent0:=:state ?	add_node:-:B add_node:-:A add_edge:-:_population arg_node:-:B arg_node:-:A add_entity_node:-:ent0:=:state arg_node:-:B return:-:A	ent0:=:state:::arizona:=:state
what state borders the state with the smallest population ?	add_node:-:A add_type_node:-:_state arg_node:-:A add_node:-:B add_edge:-:_next_to arg_node:-:A arg_node:-:B add_operation:-:_smallest add_type_node:-:_state arg_node:-:B add_node:-:C add_edge:-:_population arg_node:-:B arg_node:-:C end_operation:-:arg ope_for:-:C return:-:A	
what is the total area of ent0:=:country ?	add_node:-:B add_node:-:A add_edge:-:_area arg_node:-:B arg_node:-:A add_entity_node:-:ent0:=:country arg_node:-:B return:-:A	ent0:=:country:::usa:=:country
what is the population of ent0:=:city ?	add_node:-:B add_node:-:A add_edge:-:_population arg_node:-:B arg_node:-:A add_entity_node:-:ent0:=:city arg_node:-:B return:-:A	ent0:=:city:::seattle_wa:=:city
what is the size of the largest state in ent0:=:country ?	add_node:-:B add_node:-:A add_edge:-:_size arg_node:-:B arg_node:-:A add_operation:-:_largest add_type_node:-:_state arg_node:-:B add_node:-:C add_edge:-:_loc arg_node:-:B arg_node:-:C add_entity_node:-:ent0:=:country arg_node:-:C end_operation:-:arg ope_for:-:B return:-:A	ent0:=:country:::usa:=:country
what state has the capital ent0:=:city ?	add_node:-:A add_type_node:-:_state arg_node:-:A add_node:-:B add_edge:-:_loc arg_node:-:B arg_node:-:A add_type_node:-:_capital arg_node:-:B add_entity_node:-:ent0:=:city arg_node:-:B return:-:A	ent0:=:city:::salem:=:city
which is the lowest point of the states that ent0:=:river runs through ?	add_operation:-:_lowest add_node:-:B add_type_node:-:_place arg_node:-:B add_node:-:A add_edge:-:_loc arg_node:-:B arg_node:-:A add_type_node:-:_state arg_node:-:A add_node:-:C add_edge:-:_traverse arg_node:-:C arg_node:-:A add_entity_node:-:ent0:=:river arg_node:-:C end_operation:-:arg ope_for:-:B return:-:B	ent0:=:river:::mississippi:=:river
how many major cities are in ent0:=:state ?	add_operation:-:_count add_node:-:B add_type_node:-:_major arg_node:-:B add_type_node:-:_city arg_node:-:B add_node:-:C add_edge:-:_loc arg_node:-:B arg_node:-:C add_entity_node:-:ent0:=:state arg_node:-:C end_operation:-:_count ope_for:-:B ope_return:-:A return:-:A	ent0:=:state:::texas:=:state
what is the capital city of the largest state in ent0:=:country ?	add_node:-:A add_type_node:-:_capital arg_node:-:A add_type_node:-:_city arg_node:-:A add_node:-:B add_edge:-:_loc arg_node:-:A arg_node:-:B add_operation:-:_largest add_type_node:-:_state arg_node:-:B add_node:-:C add_edge:-:_loc arg_node:-:B arg_node:-:C add_entity_node:-:ent0:=:country arg_node:-:C end_operation:-:arg ope_for:-:B return:-:A	ent0:=:country:::usa:=:country
what are the major cities in ent0:=:state ?	add_node:-:A add_type_node:-:_major arg_node:-:A add_type_node:-:_city arg_node:-:A add_node:-:B add_edge:-:_loc arg_node:-:A arg_node:-:B add_entity_node:-:ent0:=:state arg_node:-:B return:-:A	ent0:=:state:::rhode_island:=:state
what state has the most people ?	add_operation:-:_largest add_node:-:A add_type_node:-:_state arg_node:-:A add_node:-:B add_edge:-:_population arg_node:-:A arg_node:-:B end_operation:-:arg ope_for:-:B return:-:A	
what is the largest city of ent0:=:state ?	add_operation:-:_largest add_node:-:A add_type_node:-:_city arg_node:-:A add_node:-:B add_edge:-:_loc arg_node:-:A arg_node:-:B add_entity_node:-:ent0:=:state arg_node:-:B end_operation:-:arg ope_for:-:A return:-:A	ent0:=:state:::kansas:=:state
what is the area of the state with the capital ent0:=:city ?	add_node:-:B add_node:-:A add_edge:-:_area arg_node:-:B arg_node:-:A add_type_node:-:_state arg_node:-:B add_node:-:C add_edge:-:_loc arg_node:-:C arg_node:-:B add_type_node:-:_capital arg_node:-:C add_entity_node:-:ent0:=:city arg_node:-:C return:-:A	ent0:=:city:::albany:=:city
what is the longest river that flows through ent0:=:state ?	add_operation:-:_longest add_node:-:A add_type_node:-:_river arg_node:-:A add_node:-:B add_edge:-:_traverse arg_node:-:A arg_node:-:B add_entity_node:-:ent0:=:state arg_node:-:B end_operation:-:arg ope_for:-:A return:-:A	ent0:=:state:::colorado:=:state
how many rivers does ent0:=:state have ?	add_operation:-:_count add_node:-:B add_type_node:-:_river arg_node:-:B add_node:-:C add_edge:-:_loc arg_node:-:B arg_node:-:C add_entity_node:-:ent0:=:state arg_node:-:C end_operation:-:_count ope_for:-:B ope_return:-:A return:-:A	ent0:=:state:::alaska:=:state
how big is ent0:=:state ?	add_node:-:B add_node:-:A add_edge:-:_size arg_node:-:B arg_node:-:A add_entity_node:-:ent0:=:state arg_node:-:B return:-:A	ent0:=:state:::massachusetts:=:state
how large is the largest city in ent0:=:state ?	add_node:-:B add_node:-:A add_edge:-:_size arg_node:-:B arg_node:-:A add_operation:-:_largest add_type_node:-:_city arg_node:-:B add_node:-:C add_edge:-:_loc arg_node:-:B arg_node:-:C add_entity_node:-:ent0:=:state arg_node:-:C end_operation:-:arg ope_for:-:B return:-:A	ent0:=:state:::alaska:=:state
how many cities are there in ent0:=:country ?	add_operation:-:_count add_node:-:B add_type_node:-:_city arg_node:-:B add_node:-:C add_edge:-:_loc arg_node:-:B arg_node:-:C add_entity_node:-:ent0:=:country arg_node:-:C end_operation:-:_count ope_for:-:B ope_return:-:A return:-:A	ent0:=:country:::usa:=:country
what states capital is ent0:=:city ?	add_node:-:A add_type_node:-:_state arg_node:-:A add_node:-:B add_edge:-:_capital arg_node:-:A arg_node:-:B add_entity_node:-:ent0:=:city arg_node:-:B return:-:A	ent0:=:city:::dover:=:city
what states border ent0:=:state ?	add_node:-:A add_type_node:-:_state arg_node:-:A add_node:-:B add_edge:-:_next_to arg_node:-:A arg_node:-:B add_entity_node:-:ent0:=:state arg_node:-:B return:-:A	ent0:=:state:::new_hampshire:=:state
what is the shortest river in ent0:=:state ?	add_operation:-:_shortest add_node:-:A add_type_node:-:_river arg_node:-:A add_node:-:B add_edge:-:_loc arg_node:-:A arg_node:-:B add_entity_node:-:ent0:=:state arg_node:-:B end_operation:-:arg ope_for:-:A return:-:A	ent0:=:state:::nebraska:=:state
how many states border ent0:=:state ?	add_operation:-:_count add_node:-:B add_type_node:-:_state arg_node:-:B add_node:-:C add_edge:-:_next_to arg_node:-:B arg_node:-:C add_entity_node:-:ent0:=:state arg_node:-:C end_operation:-:_count ope_for:-:B ope_return:-:A return:-:A	ent0:=:state:::hawaii:=:state
what state is ent0:=:city in ?	add_node:-:A add_type_node:-:_state arg_node:-:A add_node:-:B add_edge:-:_loc arg_node:-:B arg_node:-:A add_entity_node:-:ent0:=:city arg_node:-:B return:-:A	ent0:=:city:::dallas:=:city
what city has the least population ?	add_operation:-:_smallest add_node:-:A add_type_node:-:_city arg_node:-:A add_node:-:B add_edge:-:_population arg_node:-:A arg_node:-:B end_operation:-:arg ope_for:-:B return:-:A	
how many people stay in ent0:=:state ?	add_node:-:B add_node:-:A add_edge:-:_population arg_node:-:B arg_node:-:A add_entity_node:-:ent0:=:state arg_node:-:B return:-:A	ent0:=:state:::utah:=:state
what state has the sparsest population density ?	add_operation:-:_smallest add_node:-:A add_type_node:-:_state arg_node:-:A add_node:-:B add_edge:-:_density arg_node:-:A arg_node:-:B end_operation:-:arg ope_for:-:B return:-:A	
what is the largest state that borders the state with the lowest point in ent0:=:country ?	add_operation:-:_largest add_node:-:A add_type_node:-:_state arg_node:-:A add_node:-:B add_edge:-:_next_to arg_node:-:A arg_node:-:B add_type_node:-:_state arg_node:-:B add_node:-:C add_edge:-:_loc arg_node:-:C arg_node:-:B add_operation:-:_lowest add_type_node:-:_place arg_node:-:C add_node:-:D add_edge:-:_loc arg_node:-:C arg_node:-:D add_entity_node:-:ent0:=:country arg_node:-:D end_operation:-:arg ope_for:-:C end_operation:-:arg ope_for:-:A return:-:A	ent0:=:country:::usa:=:country
what is the largest city in ent0:=:state ?	add_operation:-:_largest add_node:-:A add_type_node:-:_city arg_node:-:A add_node:-:B add_edge:-:_loc arg_node:-:A arg_node:-:B add_entity_node:-:ent0:=:state arg_node:-:B end_operation:-:arg ope_for:-:A return:-:A	ent0:=:state:::texas:=:state
what is the largest state in ent0:=:country ?	add_operation:-:_largest add_node:-:A add_type_node:-:_state arg_node:-:A add_node:-:B add_edge:-:_loc arg_node:-:A arg_node:-:B add_entity_node:-:ent0:=:country arg_node:-:B end_operation:-:arg ope_for:-:A return:-:A	ent0:=:country:::usa:=:country
which state has the most people ?	add_operation:-:_largest add_node:-:A add_type_node:-:_state arg_node:-:A add_node:-:B add_edge:-:_population arg_node:-:A arg_node:-:B end_operation:-:arg ope_for:-:B return:-:A	
what rivers are in ent0:=:state ?	add_node:-:A add_type_node:-:_river arg_node:-:A add_node:-:B add_edge:-:_loc arg_node:-:A arg_node:-:B add_entity_node:-:ent0:=:state arg_node:-:B return:-:A	ent0:=:state:::new_mexico:=:state
what is the area of ent0:=:state in square kilometers ?	add_node:-:B add_node:-:A add_edge:-:_area arg_node:-:B arg_node:-:A add_entity_node:-:ent0:=:state arg_node:-:B return:-:A	ent0:=:state:::maryland:=:state
how many states are there in ent0:=:country ?	add_operation:-:_count add_node:-:B add_type_node:-:_state arg_node:-:B add_node:-:C add_edge:-:_loc arg_node:-:B arg_node:-:C add_entity_node:-:ent0:=:country arg_node:-:C end_operation:-:_count ope_for:-:B ope_return:-:A return:-:A	ent0:=:country:::usa:=:country
how many major cities are in states bordering ent0:=:state ?	add_operation:-:_count add_node:-:B add_type_node:-:_major arg_node:-:B add_type_node:-:_city arg_node:-:B add_node:-:C add_edge:-:_loc arg_node:-:B arg_node:-:C add_type_node:-:_state arg_node:-:C add_node:-:D add_edge:-:_next_to arg_node:-:C arg_node:-:D add_entity_node:-:ent0:=:state arg_node:-:D end_operation:-:_count ope_for:-:B ope_return:-:A return:-:A	ent0:=:state:::nebraska:=:state
what is the population of the largest state ?	add_node:-:B add_node:-:A add_edge:-:_population arg_node:-:B arg_node:-:A add_operation:-:_largest add_type_node:-:_state arg_node:-:B end_operation:-:arg ope_for:-:B return:-:A	
what is the size of ent0:=:state ?	add_node:-:B add_node:-:A add_edge:-:_size arg_node:-:B arg_node:-:A add_entity_node:-:ent0:=:state arg_node:-:B return:-:A	ent0:=:state:::florida:=:state
how many rivers are in ent0:=:state ?	add_operation:-:_count add_node:-:B add_type_node:-:_river arg_node:-:B add_node:-:C add_edge:-:_loc arg_node:-:B arg_node:-:C add_entity_node:-:ent0:=:state arg_node:-:C end_operation:-:_count ope_for:-:B ope_return:-:A return:-:A	ent0:=:state:::missouri:=:state
how many rivers are there in ent0:=:state ?	add_operation:-:_count add_node:-:B add_type_node:-:_river arg_node:-:B add_node:-:C add_edge:-:_loc arg_node:-:B arg_node:-:C add_entity_node:-:ent0:=:state arg_node:-:C end_operation:-:_count ope_for:-:B ope_return:-:A return:-:A	ent0:=:state:::texas:=:state
what is the highest point in the state with the capital ent0:=:city ?	add_operation:-:_highest add_node:-:A add_type_node:-:_place arg_node:-:A add_node:-:B add_edge:-:_loc arg_node:-:A arg_node:-:B add_type_node:-:_state arg_node:-:B add_node:-:C add_edge:-:_loc arg_node:-:C arg_node:-:B add_type_node:-:_capital arg_node:-:C add_entity_node:-:ent0:=:city arg_node:-:C end_operation:-:arg ope_for:-:A return:-:A	ent0:=:city:::des_moines:=:city
what is the population of ent0:=:city ?	add_node:-:B add_node:-:A add_edge:-:_population arg_node:-:B arg_node:-:A add_entity_node:-:ent0:=:city arg_node:-:B return:-:A	ent0:=:city:::seattle:=:city
what is the highest point in ent0:=:state ?	add_operation:-:_highest add_node:-:A add_type_node:-:_place arg_node:-:A add_node:-:B add_edge:-:_loc arg_node:-:A arg_node:-:B add_entity_node:-:ent0:=:state arg_node:-:B end_operation:-:arg ope_for:-:A return:-:A	ent0:=:state:::colorado:=:state
which states border ent0:=:state ?	add_node:-:A add_type_node:-:_state arg_node:-:A add_node:-:B add_edge:-:_next_to arg_node:-:A arg_node:-:B add_entity_node:-:ent0:=:state arg_node:-:B return:-:A	ent0:=:state:::arizona:=:state
what rivers run through the state with the lowest point in ent0:=:country ?	add_node:-:A add_type_node:-:_river arg_node:-:A add_node:-:B add_edge:-:_traverse arg_node:-:A arg_node:-:B add_type_node:-:_state arg_node:-:B add_node:-:C add_edge:-:_loc arg_node:-:C arg_node:-:B add_operation:-:_lowest add_type_node:-:_place arg_node:-:C add_node:-:D add_edge:-:_loc arg_node:-:C arg_node:-:D add_entity_node:-:ent0:=:country arg_node:-:D end_operation:-:arg ope_for:-:C return:-:A	ent0:=:country:::usa:=:country
what is the population of ent0:=:state ?	add_node:-:B add_node:-:A add_edge:-:_population arg_node:-:B arg_node:-:A add_entity_node:-:ent0:=:state arg_node:-:B return:-:A	ent0:=:state:::minnesota:=:state
what state has the city with the most population ?	add_node:-:A add_type_node:-:_state arg_node:-:A add_node:-:B add_edge:-:_loc arg_node:-:B arg_node:-:A add_operation:-:_largest add_type_node:-:_city arg_node:-:B add_node:-:C add_edge:-:_population arg_node:-:B arg_node:-:C end_operation:-:arg ope_for:-:C return:-:A	
which states have a major city named ent0:=:city ?	add_node:-:A add_type_node:-:_state arg_node:-:A add_node:-:B add_edge:-:_loc arg_node:-:B arg_node:-:A add_type_node:-:_major arg_node:-:B add_type_node:-:_city arg_node:-:B add_entity_node:-:ent0:=:city arg_node:-:B return:-:A	ent0:=:city:::austin:=:city
which states have points higher than the highest point in ent0:=:state ?	add_node:-:A add_type_node:-:_state arg_node:-:A add_node:-:B add_edge:-:_loc arg_node:-:B arg_node:-:A add_type_node:-:_place arg_node:-:B add_node:-:C add_edge:-:_higher arg_node:-:B arg_node:-:C add_operation:-:_highest add_type_node:-:_place arg_node:-:C add_node:-:D add_edge:-:_loc arg_node:-:C arg_node:-:D add_entity_node:-:ent0:=:state arg_node:-:D end_operation:-:arg ope_for:-:C return:-:A	ent0:=:state:::colorado:=:state
what is the highest point in the state with the smallest population ?	add_operation:-:_highest add_node:-:A add_type_node:-:_place arg_node:-:A add_node:-:B add_edge:-:_loc arg_node:-:A arg_node:-:B add_operation:-:_smallest add_type_node:-:_state arg_node:-:B add_node:-:C add_edge:-:_population arg_node:-:B arg_node:-:C end_operation:-:arg ope_for:-:C end_operation:-:arg ope_for:-:A return:-:A	
where is ent0:=:state ?	add_node:-:B add_node:-:A add_edge:-:_loc arg_node:-:B arg_node:-:A add_entity_node:-:ent0:=:state arg_node:-:B return:-:A	ent0:=:state:::new_hampshire:=:state
which state borders ent0:=:state ?	add_node:-:A add_type_node:-:_state arg_node:-:A add_node:-:B add_edge:-:_next_to arg_node:-:A arg_node:-:B add_entity_node:-:ent0:=:state arg_node:-:B return:-:A	ent0:=:state:::florida:=:state
how many rivers in ent0:=:state are longer than ent0:=:river ?	add_operation:-:_count add_node:-:B add_type_node:-:_river arg_node:-:B add_node:-:C add_edge:-:_loc arg_node:-:B arg_node:-:C add_entity_node:-:ent0:=:state arg_node:-:C add_node:-:D add_edge:-:_longer arg_node:-:B arg_node:-:D add_entity_node:-:ent0:=:river arg_node:-:D end_operation:-:_count ope_for:-:B ope_return:-:A return:-:A	ent0:=:state:::texas:=:state ent0:=:river:::red:=:river
how many rivers do not traverse the state with the capital ent0:=:city ?	add_operation:-:_count add_node:-:B add_type_node:-:_river arg_node:-:B add_operation:-:_not add_node:-:C add_edge:-:_traverse arg_node:-:B arg_node:-:C add_type_node:-:_state arg_node:-:C add_node:-:D add_edge:-:_loc arg_node:-:D arg_node:-:C add_type_node:-:_capital arg_node:-:D add_entity_node:-:ent0:=:city arg_node:-:D end_operation:-:_not end_operation:-:_count ope_for:-:B ope_return:-:A return:-:A	ent0:=:city:::albany:=:city
what are the populations of the states through which ent0:=:river run ?	add_node:-:B add_node:-:A add_edge:-:_population arg_node:-:B arg_node:-:A add_type_node:-:_state arg_node:-:B add_node:-:C add_edge:-:_traverse arg_node:-:C arg_node:-:B add_entity_node:-:ent0:=:river arg_node:-:C return:-:A	ent0:=:river:::mississippi:=:river
through which states does ent0:=:river run ?	add_node:-:A add_type_node:-:_state arg_node:-:A add_node:-:B add_edge:-:_traverse arg_node:-:B arg_node:-:A add_entity_node:-:ent0:=:river arg_node:-:B return:-:A	ent0:=:river:::mississippi:=:river
what states are next to ent0:=:state ?	add_node:-:A add_type_node:-:_state arg_node:-:A add_node:-:B add_edge:-:_next_to arg_node:-:A arg_node:-:B add_entity_node:-:ent0:=:state arg_node:-:B return:-:A	ent0:=:state:::mississippi:=:state
give me the cities in ent0:=:state ?	add_node:-:A add_type_node:-:_city arg_node:-:A add_node:-:B add_edge:-:_loc arg_node:-:A arg_node:-:B add_entity_node:-:ent0:=:state arg_node:-:B return:-:A	ent0:=:state:::virginia:=:state
what are the capital cities of the states which border ent0:=:state ?	add_node:-:A add_type_node:-:_capital arg_node:-:A add_type_node:-:_city arg_node:-:A add_node:-:B add_edge:-:_loc arg_node:-:A arg_node:-:B add_type_node:-:_state arg_node:-:B add_node:-:C add_edge:-:_next_to arg_node:-:B arg_node:-:C add_entity_node:-:ent0:=:state arg_node:-:C return:-:A	ent0:=:state:::texas:=:state
what state that borders ent0:=:state has the highest population ?	add_operation:-:_largest add_node:-:A add_type_node:-:_state arg_node:-:A add_node:-:C add_edge:-:_next_to arg_node:-:A arg_node:-:C add_entity_node:-:ent0:=:state arg_node:-:C add_node:-:B add_edge:-:_population arg_node:-:A arg_node:-:B end_operation:-:arg ope_for:-:B return:-:A	ent0:=:state:::texas:=:state
what state is the state with the most rivers ?	add_node:-:A add_type_node:-:_state arg_node:-:A add_operation:-:_most add_type_node:-:_state arg_node:-:A add_node:-:B add_edge:-:_loc arg_node:-:B arg_node:-:A add_type_node:-:_river arg_node:-:B end_operation:-:arg_count ope_for:-:A ope_for:-:B return:-:A	
what state has the least population density ?	add_operation:-:_smallest add_node:-:A add_type_node:-:_state arg_node:-:A add_node:-:B add_edge:-:_density arg_node:-:A arg_node:-:B end_operation:-:arg ope_for:-:B return:-:A	
what are the major cities in ent0:=:state ?	add_node:-:A add_type_node:-:_major arg_node:-:A add_type_node:-:_city arg_node:-:A add_node:-:B add_edge:-:_loc arg_node:-:A arg_node:-:B add_entity_node:-:ent0:=:state arg_node:-:B return:-:A	ent0:=:state:::ohio:=:state
which states does ent0:=:river run through ?	add_node:-:A add_type_node:-:_state arg_node:-:A add_node:-:B add_edge:-:_traverse arg_node:-:B arg_node:-:A add_entity_node:-:ent0:=:river arg_node:-:B add_type_node:-:_river arg_node:-:B return:-:A	ent0:=:river:::missouri:=:river
what is the biggest city in ent0:=:state ?	add_operation:-:_largest add_node:-:A add_type_node:-:_city arg_node:-:A add_node:-:B add_edge:-:_loc arg_node:-:A arg_node:-:B add_entity_node:-:ent0:=:state arg_node:-:B end_operation:-:arg ope_for:-:A return:-:A	ent0:=:state:::arizona:=:state
how many people live in ent0:=:state ?	add_node:-:B add_node:-:A add_edge:-:_population arg_node:-:B arg_node:-:A add_entity_node:-:ent0:=:state arg_node:-:B return:-:A	ent0:=:state:::hawaii:=:state
how many people live in the smallest state bordering ent0:=:state ?	add_node:-:B add_node:-:A add_edge:-:_population arg_node:-:B arg_node:-:A add_operation:-:_smallest add_type_node:-:_state arg_node:-:B add_node:-:C add_edge:-:_next_to arg_node:-:B arg_node:-:C add_entity_node:-:ent0:=:state arg_node:-:C end_operation:-:arg ope_for:-:B return:-:A	ent0:=:state:::wyoming:=:state
what is the name of the state with the lowest point ?	add_node:-:A add_type_node:-:_state arg_node:-:A add_node:-:B add_edge:-:_loc arg_node:-:B arg_node:-:A add_operation:-:_lowest add_type_node:-:_place arg_node:-:B end_operation:-:arg ope_for:-:B return:-:A	
what rivers flow through ent0:=:state ?	add_node:-:A add_type_node:-:_river arg_node:-:A add_node:-:B add_edge:-:_traverse arg_node:-:A arg_node:-:B add_entity_node:-:ent0:=:state arg_node:-:B return:-:A	ent0:=:state:::missouri:=:state
what is the elevation of ent0:=:place ?	add_node:-:B add_node:-:A add_edge:-:_elevation arg_node:-:B arg_node:-:A add_entity_node:-:ent0:=:place arg_node:-:B return:-:A	ent0:=:place:::death_valley:=:place
what river flows through ent0:=:state ?	add_node:-:A add_type_node:-:_river arg_node:-:A add_node:-:B add_edge:-:_traverse arg_node:-:A arg_node:-:B add_entity_node:-:ent0:=:state arg_node:-:B return:-:A	ent0:=:state:::texas:=:state
how high are the highest points of all the states ?	add_node:-:B add_node:-:A add_edge:-:_elevation arg_node:-:B arg_node:-:A add_operation:-:_highest add_type_node:-:_place arg_node:-:B add_node:-:C add_edge:-:_loc arg_node:-:B arg_node:-:C add_type_node:-:_state arg_node:-:C end_operation:-:arg ope_for:-:B return:-:A	
what is the capital of ent0:=:state ?	add_node:-:A add_type_node:-:_capital arg_node:-:A add_node:-:B add_edge:-:_loc arg_node:-:A arg_node:-:B add_entity_node:-:ent0:=:state arg_node:-:B return:-:A	ent0:=:state:::new_hampshire:=:state
how long is ent0:=:river ?	add_node:-:B add_node:-:A add_edge:-:_len arg_node:-:B arg_node:-:A add_entity_node:-:ent0:=:river arg_node:-:B add_type_node:-:_river arg_node:-:B return:-:A	ent0:=:river:::rio_grande:=:river
which state borders most states ?	add_operation:-:_most add_node:-:A add_type_node:-:_state arg_node:-:A add_node:-:B add_edge:-:_next_to arg_node:-:A arg_node:-:B add_type_node:-:_state arg_node:-:B end_operation:-:arg_count ope_for:-:A ope_for:-:B return:-:A	
how many states does ent0:=:state border ?	add_operation:-:_count add_node:-:B add_type_node:-:_state arg_node:-:B add_node:-:C add_edge:-:_next_to arg_node:-:C arg_node:-:B add_entity_node:-:ent0:=:state arg_node:-:C end_operation:-:_count ope_for:-:B ope_return:-:A return:-:A	ent0:=:state:::missouri:=:state
where is ent0:=:city ?	add_node:-:B add_node:-:A add_edge:-:_loc arg_node:-:B arg_node:-:A add_entity_node:-:ent0:=:city arg_node:-:B return:-:A	ent0:=:city:::austin:=:city
how high is the highest point of ent0:=:state ?	add_node:-:B add_node:-:A add_edge:-:_elevation arg_node:-:B arg_node:-:A add_operation:-:_highest add_type_node:-:_place arg_node:-:B add_node:-:C add_edge:-:_loc arg_node:-:B arg_node:-:C add_entity_node:-:ent0:=:state arg_node:-:C end_operation:-:arg ope_for:-:B return:-:A	ent0:=:state:::delaware:=:state
where is the highest point in ent0:=:state ?	add_operation:-:_highest add_node:-:A add_type_node:-:_place arg_node:-:A add_node:-:B add_edge:-:_loc arg_node:-:A arg_node:-:B add_entity_node:-:ent0:=:state arg_node:-:B end_operation:-:arg ope_for:-:A return:-:A	ent0:=:state:::montana:=:state
what states border states that border the state with the largest population ?	add_node:-:A add_type_node:-:_state arg_node:-:A add_node:-:B add_edge:-:_next_to arg_node:-:A arg_node:-:B add_type_node:-:_state arg_node:-:B add_node:-:C add_edge:-:_next_to arg_node:-:B arg_node:-:C add_operation:-:_largest add_type_node:-:_state arg_node:-:C add_node:-:D add_edge:-:_population arg_node:-:C arg_node:-:D end_operation:-:arg ope_for:-:D return:-:A	
what is the height of the highest mountain in ent0:=:state ?	add_node:-:B add_node:-:A add_edge:-:_elevation arg_node:-:B arg_node:-:A add_operation:-:_highest add_type_node:-:_mountain arg_node:-:B add_node:-:C add_edge:-:_loc arg_node:-:B arg_node:-:C add_entity_node:-:ent0:=:state arg_node:-:C end_operation:-:arg ope_for:-:B return:-:A	ent0:=:state:::texas:=:state
what state has the city ent0:=:city ?	add_node:-:A add_type_node:-:_state arg_node:-:A add_node:-:B add_edge:-:_loc arg_node:-:B arg_node:-:A add_type_node:-:_city arg_node:-:B add_entity_node:-:ent0:=:city arg_node:-:B return:-:A	ent0:=:city:::flint:=:city
what is the state with the largest density in ent0:=:country ?	add_operation:-:_largest add_node:-:A add_type_node:-:_state arg_node:-:A add_node:-:B add_edge:-:_density arg_node:-:A arg_node:-:B add_node:-:C add_edge:-:_loc arg_node:-:A arg_node:-:C add_entity_node:-:ent0:=:country arg_node:-:C end_operation:-:arg ope_for:-:B return:-:A	ent0:=:country:::usa:=:country
what cities in ent0:=:state have the highest number of citizens ?	add_operation:-:_largest add_node:-:A add_type_node:-:_city arg_node:-:A add_node:-:C add_edge:-:_loc arg_node:-:A arg_node:-:C add_entity_node:-:ent0:=:state arg_node:-:C add_node:-:B add_edge:-:_population arg_node:-:A arg_node:-:B end_operation:-:arg ope_for:-:B return:-:A	ent0:=:state:::texas:=:state
what states border ent0:=:state ?	add_node:-:A add_type_node:-:_state arg_node:-:A add_node:-:B add_edge:-:_next_to arg_node:-:A arg_node:-:B add_entity_node:-:ent0:=:state arg_node:-:B return:-:A	ent0:=:state:::missouri:=:state
give me the largest state ?	add_operation:-:_largest add_node:-:A add_type_node:-:_state arg_node:-:A end_operation:-:arg ope_for:-:A return:-:A	
which state has the sparsest population density ?	add_operation:-:_smallest add_node:-:A add_type_node:-:_state arg_node:-:A add_node:-:B add_edge:-:_density arg_node:-:A arg_node:-:B end_operation:-:arg ope_for:-:B return:-:A	
which states border ent0:=:state ?	add_node:-:A add_type_node:-:_state arg_node:-:A add_node:-:B add_edge:-:_next_to arg_node:-:A arg_node:-:B add_entity_node:-:ent0:=:state arg_node:-:B return:-:A	ent0:=:state:::alabama:=:state
what rivers flow through states that ent0:=:state borders ?	add_node:-:A add_type_node:-:_river arg_node:-:A add_node:-:B add_edge:-:_traverse arg_node:-:A arg_node:-:B add_type_node:-:_state arg_node:-:B add_node:-:C add_edge:-:_next_to arg_node:-:C arg_node:-:B add_entity_node:-:ent0:=:state arg_node:-:C return:-:A	ent0:=:state:::alabama:=:state
what are the major cities in ent0:=:state ?	add_node:-:A add_type_node:-:_major arg_node:-:A add_type_node:-:_city arg_node:-:A add_node:-:B add_edge:-:_loc arg_node:-:A arg_node:-:B add_entity_node:-:ent0:=:state arg_node:-:B return:-:A	ent0:=:state:::wyoming:=:state
what are the highest points of states surrounding ent0:=:state ?	add_operation:-:_highest add_node:-:A add_type_node:-:_place arg_node:-:A add_node:-:B add_edge:-:_loc arg_node:-:A arg_node:-:B add_type_node:-:_state arg_node:-:B add_node:-:C add_edge:-:_next_to arg_node:-:B arg_node:-:C add_entity_node:-:ent0:=:state arg_node:-:C end_operation:-:arg ope_for:-:A return:-:A	ent0:=:state:::mississippi:=:state
through which states does ent0:=:river flow ?	add_node:-:A add_type_node:-:_state arg_node:-:A add_node:-:B add_edge:-:_traverse arg_node:-:B arg_node:-:A add_entity_node:-:ent0:=:river arg_node:-:B return:-:A	ent0:=:river:::mississippi:=:river
where is ent0:=:city ?	add_node:-:B add_node:-:A add_edge:-:_loc arg_node:-:B arg_node:-:A add_entity_node:-:ent0:=:city arg_node:-:B return:-:A	ent0:=:city:::scotts_valley:=:city
what are the major lakes in ent0:=:country ?	add_node:-:A add_type_node:-:_major arg_node:-:A add_type_node:-:_lake arg_node:-:A add_node:-:B add_edge:-:_loc arg_node:-:A arg_node:-:B add_entity_node:-:ent0:=:country arg_node:-:B return:-:A	ent0:=:country:::usa:=:country
what is the largest city in ent0:=:state ?	add_operation:-:_largest add_node:-:A add_type_node:-:_city arg_node:-:A add_node:-:B add_edge:-:_loc arg_node:-:A arg_node:-:B add_entity_node:-:ent0:=:state arg_node:-:B end_operation:-:arg ope_for:-:A return:-:A	ent0:=:state:::missouri:=:state
what states border ent0:=:state ?	add_node:-:A add_type_node:-:_state arg_node:-:A add_node:-:B add_edge:-:_next_to arg_node:-:A arg_node:-:B add_entity_node:-:ent0:=:state arg_node:-:B return:-:A	ent0:=:state:::alaska:=:state
what state has the largest city ?	add_operation:-:_largest add_node:-:A add_type_node:-:_state arg_node:-:A add_node:-:B add_edge:-:_loc arg_node:-:B arg_node:-:A add_type_node:-:_city arg_node:-:B end_operation:-:arg ope_for:-:B return:-:A	
what rivers run through ent0:=:state ?	add_node:-:A add_type_node:-:_river arg_node:-:A add_node:-:B add_edge:-:_traverse arg_node:-:A arg_node:-:B add_entity_node:-:ent0:=:state arg_node:-:B return:-:A	ent0:=:state:::maine:=:state
give me the lakes in ent0:=:state ?	add_node:-:A add_type_node:-:_lake arg_node:-:A add_node:-:B add_edge:-:_loc arg_node:-:A arg_node:-:B add_entity_node:-:ent0:=:state arg_node:-:B return:-:A	ent0:=:state:::california:=:state
what is the combined population of all 50 states ?	add_operation:-:_sum add_node:-:C add_type_node:-:_state arg_node:-:C add_type_node:-:_population arg_node:-:C end_operation:-:_sum ope_for:-:C ope_in:-:_population ope_return:-:A return:-:A	
how high is the highest point of ent0:=:state ?	add_node:-:B add_node:-:A add_edge:-:_elevation arg_node:-:B arg_node:-:A add_operation:-:_highest add_type_node:-:_place arg_node:-:B add_node:-:C add_edge:-:_loc arg_node:-:B arg_node:-:C add_entity_node:-:ent0:=:state arg_node:-:C end_operation:-:arg ope_for:-:B return:-:A	ent0:=:state:::louisiana:=:state
what is the longest river in ent0:=:state ?	add_operation:-:_longest add_node:-:A add_type_node:-:_river arg_node:-:A add_node:-:B add_edge:-:_loc arg_node:-:A arg_node:-:B add_entity_node:-:ent0:=:state arg_node:-:B end_operation:-:arg ope_for:-:A return:-:A	ent0:=:state:::pennsylvania:=:state
what is the capital of ent0:=:state ?	add_node:-:A add_type_node:-:_capital arg_node:-:A add_node:-:B add_edge:-:_loc arg_node:-:A arg_node:-:B add_entity_node:-:ent0:=:state arg_node:-:B return:-:A	ent0:=:state:::maryland:=:state
what state is the biggest ?	add_operation:-:_largest add_node:-:A add_type_node:-:_state arg_node:-:A end_operation:-:arg ope_for:-:A return:-:A	
which states border ent0:=:state ?	add_node:-:A add_type_node:-:_state arg_node:-:A add_node:-:B add_edge:-:_next_to arg_node:-:A arg_node:-:B add_entity_node:-:ent0:=:state arg_node:-:B return:-:A	ent0:=:state:::iowa:=:state
which states border ent0:=:state ?	add_node:-:A add_type_node:-:_state arg_node:-:A add_node:-:B add_edge:-:_next_to arg_node:-:A arg_node:-:B add_entity_node:-:ent0:=:state arg_node:-:B return:-:A	ent0:=:state:::alaska:=:state
what is the largest state in ent0:=:country ?	add_operation:-:_largest add_node:-:A add_type_node:-:_state arg_node:-:A add_node:-:B add_edge:-:_loc arg_node:-:A arg_node:-:B add_entity_node:-:ent0:=:country arg_node:-:B end_operation:-:arg ope_for:-:A return:-:A	ent0:=:country:::usa:=:country
what are the major cities in ent0:=:state ?	add_node:-:A add_type_node:-:_major arg_node:-:A add_type_node:-:_city arg_node:-:A add_node:-:B add_edge:-:_loc arg_node:-:A arg_node:-:B add_entity_node:-:ent0:=:state arg_node:-:B return:-:A	ent0:=:state:::california:=:state
what is the largest state traversed by ent0:=:river ?	add_operation:-:_largest add_node:-:A add_type_node:-:_state arg_node:-:A add_node:-:B add_edge:-:_traverse arg_node:-:B arg_node:-:A add_entity_node:-:ent0:=:river arg_node:-:B end_operation:-:arg ope_for:-:A return:-:A	ent0:=:river:::mississippi:=:river
which rivers run through states bordering ent0:=:state ?	add_node:-:A add_type_node:-:_river arg_node:-:A add_node:-:B add_edge:-:_traverse arg_node:-:A arg_node:-:B add_type_node:-:_state arg_node:-:B add_node:-:C add_edge:-:_next_to arg_node:-:B arg_node:-:C add_entity_node:-:ent0:=:state arg_node:-:C return:-:A	ent0:=:state:::new_mexico:=:state
what is the lowest point in ent0:=:state ?	add_operation:-:_lowest add_node:-:A add_type_node:-:_place arg_node:-:A add_node:-:B add_edge:-:_loc arg_node:-:A arg_node:-:B add_type_node:-:_state arg_node:-:B add_entity_node:-:ent0:=:state arg_node:-:B end_operation:-:arg ope_for:-:A return:-:A	ent0:=:state:::texas:=:state
what is the smallest state bordering ent0:=:state ?	add_operation:-:_smallest add_node:-:A add_type_node:-:_state arg_node:-:A add_node:-:B add_edge:-:_next_to arg_node:-:A arg_node:-:B add_entity_node:-:ent0:=:state arg_node:-:B end_operation:-:arg ope_for:-:A return:-:A	ent0:=:state:::ohio:=:state
how many states are next to major rivers ?	add_operation:-:_count add_node:-:B add_type_node:-:_state arg_node:-:B add_node:-:C add_edge:-:_next_to arg_node:-:B arg_node:-:C add_type_node:-:_major arg_node:-:C add_type_node:-:_river arg_node:-:C end_operation:-:_count ope_for:-:B ope_return:-:A return:-:A	
what is the lowest point of ent0:=:country ?	add_operation:-:_lowest add_node:-:A add_type_node:-:_place arg_node:-:A add_node:-:B add_edge:-:_loc arg_node:-:A arg_node:-:B add_entity_node:-:ent0:=:country arg_node:-:B end_operation:-:arg ope_for:-:A return:-:A	ent0:=:country:::usa:=:country
which state has the greatest density ?	add_operation:-:_largest add_node:-:A add_type_node:-:_state arg_node:-:A add_node:-:B add_edge:-:_density arg_node:-:A arg_node:-:B end_operation:-:arg ope_for:-:B return:-:A	
how many states border the largest state ?	add_operation:-:_count add_node:-:B add_type_node:-:_state arg_node:-:B add_node:-:C add_edge:-:_next_to arg_node:-:B arg_node:-:C add_operation:-:_largest add_type_node:-:_state arg_node:-:C end_operation:-:arg ope_for:-:C end_operation:-:_count ope_for:-:B ope_return:-:A return:-:A	
what is the longest river that does not run through ent0:=:state ?	add_operation:-:_longest add_node:-:A add_type_node:-:_river arg_node:-:A add_operation:-:_not add_node:-:B add_edge:-:_traverse arg_node:-:A arg_node:-:B add_entity_node:-:ent0:=:state arg_node:-:B end_operation:-:_not end_operation:-:arg ope_for:-:A return:-:A	ent0:=:state:::texas:=:state
give me all the states of ent0:=:country ?	add_node:-:A add_type_node:-:_state arg_node:-:A add_node:-:B add_edge:-:_loc arg_node:-:A arg_node:-:B add_entity_node:-:ent0:=:country arg_node:-:B return:-:A	ent0:=:country:::usa:=:country
what is the density of ent0:=:state ?	add_node:-:B add_node:-:A add_edge:-:_density arg_node:-:B arg_node:-:A add_entity_node:-:ent0:=:state arg_node:-:B return:-:A	ent0:=:state:::texas:=:state
what is the smallest city of the smallest state in ent0:=:country ?	add_operation:-:_smallest add_node:-:A add_type_node:-:_city arg_node:-:A add_node:-:B add_edge:-:_loc arg_node:-:A arg_node:-:B add_operation:-:_smallest add_type_node:-:_state arg_node:-:B add_node:-:C add_edge:-:_loc arg_node:-:B arg_node:-:C add_entity_node:-:ent0:=:country arg_node:-:C end_operation:-:arg ope_for:-:B end_operation:-:arg ope_for:-:A return:-:A	ent0:=:country:::usa:=:country
what is the highest point in ent0:=:state ?	add_operation:-:_highest add_node:-:A add_type_node:-:_place arg_node:-:A add_node:-:B add_edge:-:_loc arg_node:-:A arg_node:-:B add_entity_node:-:ent0:=:state arg_node:-:B end_operation:-:arg ope_for:-:A return:-:A	ent0:=:state:::kansas:=:state
what is the population in ent0:=:city ?	add_node:-:B add_node:-:A add_edge:-:_population arg_node:-:B arg_node:-:A add_entity_node:-:ent0:=:city arg_node:-:B return:-:A	ent0:=:city:::boston:=:city
how many people are in the state of ent0:=:state ?	add_node:-:B add_node:-:A add_edge:-:_population arg_node:-:B arg_node:-:A add_entity_node:-:ent0:=:state arg_node:-:B return:-:A	ent0:=:state:::nevada:=:state
what is the population density of ent0:=:state ?	add_node:-:B add_node:-:A add_edge:-:_density arg_node:-:B arg_node:-:A add_entity_node:-:ent0:=:state arg_node:-:B return:-:A	ent0:=:state:::texas:=:state
how many people live in ent0:=:city ?	add_node:-:B add_node:-:A add_edge:-:_population arg_node:-:B arg_node:-:A add_entity_node:-:ent0:=:city arg_node:-:B return:-:A	ent0:=:city:::washington_dc:=:city
give me the cities in ent0:=:state ?	add_node:-:A add_type_node:-:_city arg_node:-:A add_node:-:B add_edge:-:_loc arg_node:-:A arg_node:-:B add_entity_node:-:ent0:=:state arg_node:-:B return:-:A	ent0:=:state:::texas:=:state
how long is the shortest river in ent0:=:country ?	add_node:-:B add_node:-:A add_edge:-:_len arg_node:-:B arg_node:-:A add_operation:-:_shortest add_type_node:-:_river arg_node:-:B add_node:-:C add_edge:-:_loc arg_node:-:B arg_node:-:C add_entity_node:-:ent0:=:country arg_node:-:C end_operation:-:arg ope_for:-:B return:-:A	ent0:=:country:::usa:=:country
how many states have major rivers ?	add_operation:-:_count add_node:-:B add_type_node:-:_state arg_node:-:B add_node:-:C add_edge:-:_loc arg_node:-:C arg_node:-:B add_type_node:-:_major arg_node:-:C add_type_node:-:_river arg_node:-:C end_operation:-:_count ope_for:-:B ope_return:-:A return:-:A	
what is the population density of the smallest state ?	add_node:-:B add_node:-:A add_edge:-:_density arg_node:-:B arg_node:-:A add_operation:-:_smallest add_type_node:-:_state arg_node:-:B end_operation:-:arg ope_for:-:B return:-:A	
which states border ent0:=:state ?	add_node:-:A add_type_node:-:_state arg_node:-:A add_node:-:B add_edge:-:_next_to arg_node:-:A arg_node:-:B add_entity_node:-:ent0:=:state arg_node:-:B return:-:A	ent0:=:state:::michigan:=:state
what cities in ent0:=:state have the highest populations ?	add_operation:-:_largest add_node:-:A add_type_node:-:_city arg_node:-:A add_node:-:C add_edge:-:_loc arg_node:-:A arg_node:-:C add_entity_node:-:ent0:=:state arg_node:-:C add_node:-:B add_edge:-:_population arg_node:-:A arg_node:-:B end_operation:-:arg ope_for:-:B return:-:A	ent0:=:state:::texas:=:state
what rivers run through the states that border the state with the capital ent0:=:city ?	add_node:-:A add_type_node:-:_river arg_node:-:A add_node:-:B add_edge:-:_traverse arg_node:-:A arg_node:-:B add_type_node:-:_state arg_node:-:B add_node:-:C add_edge:-:_next_to arg_node:-:B arg_node:-:C add_type_node:-:_state arg_node:-:C add_node:-:D add_edge:-:_loc arg_node:-:D arg_node:-:C add_type_node:-:_capital arg_node:-:D add_entity_node:-:ent0:=:city arg_node:-:D return:-:A	ent0:=:city:::atlanta:=:city
what is the highest point in ent0:=:country ?	add_operation:-:_highest add_node:-:A add_type_node:-:_place arg_node:-:A add_node:-:B add_edge:-:_loc arg_node:-:A arg_node:-:B add_entity_node:-:ent0:=:country arg_node:-:B end_operation:-:arg ope_for:-:A return:-:A	ent0:=:country:::usa:=:country
how many people live in ent0:=:city ?	add_node:-:B add_node:-:A add_edge:-:_population arg_node:-:B arg_node:-:A add_entity_node:-:ent0:=:city arg_node:-:B return:-:A	ent0:=:city:::kalamazoo:=:city
how many major cities are in ent0:=:state ?	add_operation:-:_count add_node:-:B add_type_node:-:_major arg_node:-:B add_type_node:-:_city arg_node:-:B add_node:-:C add_edge:-:_loc arg_node:-:B arg_node:-:C add_entity_node:-:ent0:=:state arg_node:-:C end_operation:-:_count ope_for:-:B ope_return:-:A return:-:A	ent0:=:state:::florida:=:state
what state has the greatest population density ?	add_operation:-:_largest add_node:-:A add_type_node:-:_state arg_node:-:A add_node:-:B add_edge:-:_density arg_node:-:A arg_node:-:B end_operation:-:arg ope_for:-:B return:-:A	
how many rivers are found in ent0:=:state ?	add_operation:-:_count add_node:-:B add_type_node:-:_river arg_node:-:B add_node:-:C add_edge:-:_loc arg_node:-:B arg_node:-:C add_entity_node:-:ent0:=:state arg_node:-:C end_operation:-:_count ope_for:-:B ope_return:-:A return:-:A	ent0:=:state:::colorado:=:state
what is the lowest point of the state with the largest area ?	add_operation:-:_lowest add_node:-:A add_type_node:-:_place arg_node:-:A add_node:-:B add_edge:-:_loc arg_node:-:A arg_node:-:B add_operation:-:_largest add_type_node:-:_state arg_node:-:B add_node:-:C add_edge:-:_area arg_node:-:B arg_node:-:C end_operation:-:arg ope_for:-:C end_operation:-:arg ope_for:-:A return:-:A	
what states border ent0:=:state ?	add_node:-:A add_type_node:-:_state arg_node:-:A add_node:-:B add_edge:-:_next_to arg_node:-:A arg_node:-:B add_entity_node:-:ent0:=:state arg_node:-:B return:-:A	ent0:=:state:::texas:=:state
how many states border at least one other state ?	add_operation:-:_count add_node:-:B add_type_node:-:_state arg_node:-:B add_node:-:C add_edge:-:_next_to arg_node:-:B arg_node:-:C add_type_node:-:_state arg_node:-:C end_operation:-:_count ope_for:-:B ope_return:-:A return:-:A	
which states border no other states ?	add_node:-:A add_type_node:-:_state arg_node:-:A add_operation:-:_not add_node:-:B add_edge:-:_next_to arg_node:-:A arg_node:-:B add_type_node:-:_state arg_node:-:B end_operation:-:_not return:-:A	
what rivers run through ent0:=:city ?	add_node:-:A add_type_node:-:_river arg_node:-:A add_node:-:B add_edge:-:_traverse arg_node:-:A arg_node:-:B add_entity_node:-:ent0:=:city arg_node:-:B return:-:A	ent0:=:city:::austin_tx:=:city
how many people live in ent0:=:state ?	add_node:-:B add_node:-:A add_edge:-:_population arg_node:-:B arg_node:-:A add_entity_node:-:ent0:=:state arg_node:-:B return:-:A	ent0:=:state:::new_hampshire:=:state
what is the capital of ent0:=:state ?	add_node:-:A add_type_node:-:_capital arg_node:-:A add_node:-:B add_edge:-:_loc arg_node:-:A arg_node:-:B add_entity_node:-:ent0:=:state arg_node:-:B return:-:A	ent0:=:state:::indiana:=:state
what states border the states with the most cities ?	add_node:-:A add_type_node:-:_state arg_node:-:A add_node:-:B add_edge:-:_next_to arg_node:-:A arg_node:-:B add_operation:-:_most add_type_node:-:_state arg_node:-:B add_node:-:C add_edge:-:_loc arg_node:-:C arg_node:-:B add_type_node:-:_city arg_node:-:C end_operation:-:arg_count ope_for:-:B ope_for:-:C return:-:A	
what is the area of the smallest state ?	add_node:-:B add_node:-:A add_edge:-:_area arg_node:-:B arg_node:-:A add_operation:-:_smallest add_type_node:-:_state arg_node:-:B end_operation:-:arg ope_for:-:B return:-:A	
which states border ent0:=:state ?	add_node:-:A add_type_node:-:_state arg_node:-:A add_node:-:B add_edge:-:_next_to arg_node:-:A arg_node:-:B add_entity_node:-:ent0:=:state arg_node:-:B return:-:A	ent0:=:state:::new_york:=:state
what is the population of ent0:=:state ?	add_node:-:B add_node:-:A add_edge:-:_population arg_node:-:B arg_node:-:A add_entity_node:-:ent0:=:state arg_node:-:B return:-:A	ent0:=:state:::maine:=:state
what is the biggest city in the smallest state ?	add_operation:-:_largest add_node:-:A add_type_node:-:_city arg_node:-:A add_node:-:B add_edge:-:_loc arg_node:-:A arg_node:-:B add_operation:-:_smallest add_type_node:-:_state arg_node:-:B end_operation:-:arg ope_for:-:B end_operation:-:arg ope_for:-:A return:-:A	
what is the elevation of the highest point in ent0:=:country ?	add_node:-:B add_node:-:A add_edge:-:_elevation arg_node:-:B arg_node:-:A add_operation:-:_highest add_type_node:-:_place arg_node:-:B add_node:-:C add_edge:-:_loc arg_node:-:B arg_node:-:C add_entity_node:-:ent0:=:country arg_node:-:C end_operation:-:arg ope_for:-:B return:-:A	ent0:=:country:::usa:=:country
what state borders the least states excluding ent0:=:state and excluding ent1:=:state ?	add_operation:-:_fewest add_node:-:A add_type_node:-:_state arg_node:-:A add_node:-:B add_edge:-:_next_to arg_node:-:A arg_node:-:B add_type_node:-:_state arg_node:-:B add_operation:-:_not add_entity_node:-:ent0:=:state arg_node:-:A end_operation:-:_not add_operation:-:_not add_entity_node:-:ent1:=:state arg_node:-:A end_operation:-:_not end_operation:-:arg_count ope_for:-:A ope_for:-:B return:-:A	ent0:=:state:::alaska:=:state ent1:=:state:::hawaii:=:state
what is the highest point in ent0:=:state ?	add_operation:-:_highest add_node:-:A add_type_node:-:_place arg_node:-:A add_node:-:B add_edge:-:_loc arg_node:-:A arg_node:-:B add_entity_node:-:ent0:=:state arg_node:-:B end_operation:-:arg ope_for:-:A return:-:A	ent0:=:state:::new_mexico:=:state
what is the biggest state ?	add_operation:-:_largest add_node:-:A add_type_node:-:_state arg_node:-:A end_operation:-:arg ope_for:-:A return:-:A	
how many people live in ent0:=:city ?	add_node:-:B add_node:-:A add_edge:-:_population arg_node:-:B arg_node:-:A add_entity_node:-:ent0:=:city arg_node:-:B return:-:A	ent0:=:city:::spokane_wa:=:city
what states does the shortest river run through ?	add_node:-:A add_type_node:-:_state arg_node:-:A add_node:-:B add_edge:-:_traverse arg_node:-:B arg_node:-:A add_operation:-:_shortest add_type_node:-:_river arg_node:-:B end_operation:-:arg ope_for:-:B return:-:A	
how long is ent0:=:river ?	add_node:-:B add_node:-:A add_edge:-:_len arg_node:-:B arg_node:-:A add_entity_node:-:ent0:=:river arg_node:-:B return:-:A	ent0:=:river:::rio_grande:=:river
how many people live in ent0:=:state ?	add_node:-:B add_node:-:A add_edge:-:_population arg_node:-:B arg_node:-:A add_entity_node:-:ent0:=:state arg_node:-:B return:-:A	ent0:=:state:::texas:=:state
where is the lowest spot in ent0:=:state ?	add_operation:-:_lowest add_node:-:A add_type_node:-:_place arg_node:-:A add_node:-:B add_edge:-:_loc arg_node:-:A arg_node:-:B add_entity_node:-:ent0:=:state arg_node:-:B end_operation:-:arg ope_for:-:A return:-:A	ent0:=:state:::iowa:=:state
what are the populations of the states through which ent0:=:river runs ?	add_node:-:B add_node:-:A add_edge:-:_population arg_node:-:B arg_node:-:A add_type_node:-:_state arg_node:-:B add_node:-:C add_edge:-:_traverse arg_node:-:C arg_node:-:B add_entity_node:-:ent0:=:river arg_node:-:C add_type_node:-:_river arg_node:-:C return:-:A	ent0:=:river:::mississippi:=:river
what is the lowest point in ent0:=:state ?	add_operation:-:_lowest add_node:-:A add_type_node:-:_place arg_node:-:A add_node:-:B add_edge:-:_loc arg_node:-:A arg_node:-:B add_entity_node:-:ent0:=:state arg_node:-:B end_operation:-:arg ope_for:-:A return:-:A	ent0:=:state:::oregon:=:state
what is the shortest river in ent0:=:state ?	add_operation:-:_shortest add_node:-:A add_type_node:-:_river arg_node:-:A add_node:-:B add_edge:-:_loc arg_node:-:A arg_node:-:B add_entity_node:-:ent0:=:state arg_node:-:B end_operation:-:arg ope_for:-:A return:-:A	ent0:=:state:::alaska:=:state
how many states border ent0:=:river ?	add_operation:-:_count add_node:-:B add_type_node:-:_state arg_node:-:B add_node:-:C add_edge:-:_next_to arg_node:-:B arg_node:-:C add_entity_node:-:ent0:=:river arg_node:-:C add_type_node:-:_river arg_node:-:C end_operation:-:_count ope_for:-:B ope_return:-:A return:-:A	ent0:=:river:::mississippi:=:river
what is the most populated capital in ent0:=:country ?	add_operation:-:_largest add_node:-:A add_node:-:B add_edge:-:_population arg_node:-:A arg_node:-:B add_type_node:-:_capital arg_node:-:A add_node:-:C add_edge:-:_loc arg_node:-:A arg_node:-:C add_entity_node:-:ent0:=:country arg_node:-:C end_operation:-:arg ope_for:-:B return:-:A	ent0:=:country:::usa:=:country
what is the highest point in ent0:=:state ?	add_operation:-:_highest add_node:-:A add_type_node:-:_place arg_node:-:A add_node:-:B add_edge:-:_loc arg_node:-:A arg_node:-:B add_entity_node:-:ent0:=:state arg_node:-:B end_operation:-:arg ope_for:-:A return:-:A	ent0:=:state:::ohio:=:state
what states border ent0:=:state ?	add_node:-:A add_type_node:-:_state arg_node:-:A add_node:-:B add_edge:-:_next_to arg_node:-:A arg_node:-:B add_entity_node:-:ent0:=:state arg_node:-:B return:-:A	ent0:=:state:::wisconsin:=:state
what states have a capital that is the highest point in the state ?	add_node:-:A add_type_node:-:_state arg_node:-:A add_node:-:B add_edge:-:_loc arg_node:-:B arg_node:-:A add_type_node:-:_capital arg_node:-:B add_edge:-:_high_point arg_node:-:A arg_node:-:B return:-:A	
how many states border ent0:=:state and border ent1:=:state ?	add_operation:-:_count add_node:-:B add_type_node:-:_state arg_node:-:B add_node:-:C add_edge:-:_next_to arg_node:-:B arg_node:-:C add_entity_node:-:ent0:=:state arg_node:-:C add_node:-:D add_edge:-:_next_to arg_node:-:B arg_node:-:D add_entity_node:-:ent1:=:state arg_node:-:D end_operation:-:_count ope_for:-:B ope_return:-:A return:-:A	ent0:=:state:::colorado:=:state ent1:=:state:::new_mexico:=:state
what are the major cities in ent0:=:state ?	add_node:-:A add_type_node:-:_major arg_node:-:A add_type_node:-:_city arg_node:-:A add_node:-:B add_edge:-:_loc arg_node:-:A arg_node:-:B add_entity_node:-:ent0:=:state arg_node:-:B return:-:A	ent0:=:state:::missouri:=:state
what are the major cities of ent0:=:state ?	add_node:-:A add_type_node:-:_major arg_node:-:A add_type_node:-:_city arg_node:-:A add_node:-:B add_edge:-:_loc arg_node:-:A arg_node:-:B add_entity_node:-:ent0:=:state arg_node:-:B return:-:A	ent0:=:state:::texas:=:state
how many rivers are called ent0:=:river ?	add_operation:-:_count add_node:-:B add_type_node:-:_river arg_node:-:B add_entity_node:-:ent0:=:river arg_node:-:B end_operation:-:_count ope_for:-:B ope_return:-:A return:-:A	ent0:=:river:::colorado:=:river
how high is the highest point in ent0:=:state ?	add_node:-:B add_node:-:A add_edge:-:_elevation arg_node:-:B arg_node:-:A add_operation:-:_highest add_type_node:-:_place arg_node:-:B add_node:-:C add_edge:-:_loc arg_node:-:B arg_node:-:C add_entity_node:-:ent0:=:state arg_node:-:C end_operation:-:arg ope_for:-:B return:-:A	ent0:=:state:::montana:=:state
how many states have cities named ent0:=:city ?	add_operation:-:_count add_node:-:B add_type_node:-:_state arg_node:-:B add_node:-:C add_edge:-:_loc arg_node:-:C arg_node:-:B add_type_node:-:_city arg_node:-:C add_entity_node:-:ent0:=:city arg_node:-:C end_operation:-:_count ope_for:-:B ope_return:-:A return:-:A	ent0:=:city:::austin:=:city
which states does ent0:=:river pass through ?	add_node:-:A add_type_node:-:_state arg_node:-:A add_node:-:B add_edge:-:_traverse arg_node:-:B arg_node:-:A add_entity_node:-:ent0:=:river arg_node:-:B return:-:A	ent0:=:river:::missouri:=:river
what is the biggest city in ent0:=:country ?	add_operation:-:_largest add_node:-:A add_type_node:-:_city arg_node:-:A add_node:-:B add_edge:-:_loc arg_node:-:A arg_node:-:B add_entity_node:-:ent0:=:country arg_node:-:B end_operation:-:arg ope_for:-:A return:-:A	ent0:=:country:::usa:=:country
how big is ent0:=:state ?	add_node:-:B add_node:-:A add_edge:-:_size arg_node:-:B arg_node:-:A add_entity_node:-:ent0:=:state arg_node:-:B return:-:A	ent0:=:state:::new_mexico:=:state
how many people live in ent0:=:state ?	add_node:-:B add_node:-:A add_edge:-:_population arg_node:-:B arg_node:-:A add_entity_node:-:ent0:=:state arg_node:-:B return:-:A	ent0:=:state:::south_dakota:=:state
what state is ent0:=:city in ?	add_node:-:A add_type_node:-:_state arg_node:-:A add_node:-:B add_edge:-:_loc arg_node:-:B arg_node:-:A add_entity_node:-:ent0:=:city arg_node:-:B return:-:A	ent0:=:city:::pittsburgh:=:city
what rivers run through ent0:=:state ?	add_node:-:A add_type_node:-:_river arg_node:-:A add_node:-:B add_edge:-:_traverse arg_node:-:A arg_node:-:B add_entity_node:-:ent0:=:state arg_node:-:B return:-:A	ent0:=:state:::arizona:=:state
how many major rivers cross ent0:=:state ?	add_operation:-:_count add_node:-:B add_type_node:-:_major arg_node:-:B add_type_node:-:_river arg_node:-:B add_node:-:C add_edge:-:_traverse arg_node:-:B arg_node:-:C add_entity_node:-:ent0:=:state arg_node:-:C end_operation:-:_count ope_for:-:B ope_return:-:A return:-:A	ent0:=:state:::ohio:=:state
how many people in ent0:=:city ?	add_node:-:B add_node:-:A add_edge:-:_population arg_node:-:B arg_node:-:A add_entity_node:-:ent0:=:city arg_node:-:B return:-:A	ent0:=:city:::boulder:=:city
how many rivers are there in ent0:=:state ?	add_operation:-:_count add_node:-:B add_type_node:-:_river arg_node:-:B add_node:-:C add_edge:-:_loc arg_node:-:B arg_node:-:C add_entity_node:-:ent0:=:state arg_node:-:C end_operation:-:_count ope_for:-:B ope_return:-:A return:-:A	ent0:=:state:::idaho:=:state
ent0:=:city which state ?	add_node:-:B add_entity_node:-:ent0:=:city arg_node:-:B add_type_node:-:_capital arg_node:-:B add_node:-:A add_edge:-:_loc arg_node:-:B arg_node:-:A add_type_node:-:_state arg_node:-:A return:-:A	ent0:=:city:::sacramento:=:city
how many cities are there in ent0:=:country ?	add_operation:-:_count add_node:-:B add_type_node:-:_city arg_node:-:B add_node:-:C add_edge:-:_loc arg_node:-:B arg_node:-:C add_entity_node:-:ent0:=:country arg_node:-:C end_operation:-:_count ope_for:-:B ope_return:-:A return:-:A	ent0:=:country:::usa:=:country
how many citizens live in ent0:=:state ?	add_node:-:B add_node:-:A add_edge:-:_population arg_node:-:B arg_node:-:A add_entity_node:-:ent0:=:state arg_node:-:B return:-:A	ent0:=:state:::california:=:state
what state has the largest urban population ?	add_operation:-:_largest add_node:-:A add_type_node:-:_state arg_node:-:A add_node:-:B add_edge:-:_population arg_node:-:A arg_node:-:B end_operation:-:arg ope_for:-:B return:-:A	
what states border ent0:=:river ?	add_node:-:A add_type_node:-:_state arg_node:-:A add_node:-:B add_edge:-:_next_to arg_node:-:A arg_node:-:B add_entity_node:-:ent0:=:river arg_node:-:B add_type_node:-:_river arg_node:-:B return:-:A	ent0:=:river:::mississippi:=:river
what can you tell me about the population of ent0:=:state ?	add_node:-:B add_node:-:A add_edge:-:_population arg_node:-:B arg_node:-:A add_entity_node:-:ent0:=:state arg_node:-:B return:-:A	ent0:=:state:::missouri:=:state
what rivers do not run through ent0:=:state ?	add_node:-:A add_type_node:-:_river arg_node:-:A add_operation:-:_not add_node:-:B add_edge:-:_traverse arg_node:-:A arg_node:-:B add_entity_node:-:ent0:=:state arg_node:-:B end_operation:-:_not return:-:A	ent0:=:state:::tennessee:=:state
what is the largest city in a state that borders ent0:=:state ?	add_operation:-:_largest add_node:-:A add_type_node:-:_city arg_node:-:A add_node:-:B add_edge:-:_loc arg_node:-:A arg_node:-:B add_type_node:-:_state arg_node:-:B add_node:-:C add_edge:-:_next_to arg_node:-:B arg_node:-:C add_entity_node:-:ent0:=:state arg_node:-:C end_operation:-:arg ope_for:-:A return:-:A	ent0:=:state:::texas:=:state
name the longest river in ent0:=:country ?	add_operation:-:_longest add_node:-:A add_type_node:-:_river arg_node:-:A add_node:-:B add_edge:-:_loc arg_node:-:A arg_node:-:B add_entity_node:-:ent0:=:country arg_node:-:B end_operation:-:arg ope_for:-:A return:-:A	ent0:=:country:::usa:=:country
how many states does ent0:=:river run through ?	add_operation:-:_count add_node:-:B add_type_node:-:_state arg_node:-:B add_node:-:C add_edge:-:_traverse arg_node:-:C arg_node:-:B add_entity_node:-:ent0:=:river arg_node:-:C end_operation:-:_count ope_for:-:B ope_return:-:A return:-:A	ent0:=:river:::mississippi:=:river
what is the largest of the state that ent0:=:river runs through ?	add_operation:-:_largest add_node:-:A add_type_node:-:_state arg_node:-:A add_node:-:B add_edge:-:_traverse arg_node:-:B arg_node:-:A add_entity_node:-:ent0:=:river arg_node:-:B end_operation:-:arg ope_for:-:A return:-:A	ent0:=:river:::rio_grande:=:river
what is the size of the capital of ent0:=:state ?	add_node:-:B add_node:-:A add_edge:-:_size arg_node:-:B arg_node:-:A add_type_node:-:_capital arg_node:-:B add_node:-:C add_edge:-:_loc arg_node:-:B arg_node:-:C add_entity_node:-:ent0:=:state arg_node:-:C return:-:A	ent0:=:state:::texas:=:state
what states have rivers running through them ?	add_node:-:A add_type_node:-:_state arg_node:-:A add_node:-:B add_edge:-:_loc arg_node:-:B arg_node:-:A add_type_node:-:_river arg_node:-:B add_edge:-:_traverse arg_node:-:B arg_node:-:A return:-:A	
what states border ent0:=:state ?	add_node:-:A add_type_node:-:_state arg_node:-:A add_node:-:B add_edge:-:_next_to arg_node:-:A arg_node:-:B add_entity_node:-:ent0:=:state arg_node:-:B return:-:A	ent0:=:state:::hawaii:=:state
how many citizens in ent0:=:city ?	add_node:-:B add_node:-:A add_edge:-:_population arg_node:-:B arg_node:-:A add_entity_node:-:ent0:=:city arg_node:-:B return:-:A	ent0:=:city:::boulder:=:city
what states border states that border states that border ent0:=:state ?	add_node:-:A add_type_node:-:_state arg_node:-:A add_node:-:B add_edge:-:_next_to arg_node:-:A arg_node:-:B add_type_node:-:_state arg_node:-:B add_node:-:C add_edge:-:_next_to arg_node:-:B arg_node:-:C add_type_node:-:_state arg_node:-:C add_node:-:D add_edge:-:_next_to arg_node:-:C arg_node:-:D add_entity_node:-:ent0:=:state arg_node:-:D return:-:A	ent0:=:state:::florida:=:state
which states border the longest river in ent0:=:country ?	add_node:-:A add_type_node:-:_state arg_node:-:A add_node:-:B add_edge:-:_next_to arg_node:-:A arg_node:-:B add_operation:-:_longest add_type_node:-:_river arg_node:-:B add_node:-:C add_edge:-:_loc arg_node:-:B arg_node:-:C add_entity_node:-:ent0:=:country arg_node:-:C end_operation:-:arg ope_for:-:B return:-:A	ent0:=:country:::usa:=:country
what is the population density of ent0:=:state ?	add_node:-:B add_node:-:A add_edge:-:_density arg_node:-:B arg_node:-:A add_entity_node:-:ent0:=:state arg_node:-:B return:-:A	ent0:=:state:::wyoming:=:state
how many people are there in ent0:=:state ?	add_node:-:B add_node:-:A add_edge:-:_population arg_node:-:B arg_node:-:A add_entity_node:-:ent0:=:state arg_node:-:B return:-:A	ent0:=:state:::iowa:=:state
what is the highest point in the state with the most rivers ?	add_operation:-:_highest add_node:-:A add_type_node:-:_place arg_node:-:A add_node:-:B add_edge:-:_loc arg_node:-:A arg_node:-:B add_operation:-:_most add_type_node:-:_state arg_node:-:B add_node:-:C add_edge:-:_traverse arg_node:-:C arg_node:-:B add_type_node:-:_river arg_node:-:C end_operation:-:arg_count ope_for:-:B ope_for:-:C end_operation:-:arg ope_for:-:A return:-:A	
number of citizens in ent0:=:city ?	add_node:-:B add_node:-:A add_edge:-:_population arg_node:-:B arg_node:-:A add_entity_node:-:ent0:=:city arg_node:-:B return:-:A	ent0:=:city:::boulder:=:city
what are the rivers of ent0:=:state ?	add_node:-:A add_type_node:-:_river arg_node:-:A add_node:-:B add_edge:-:_loc arg_node:-:A arg_node:-:B add_entity_node:-:ent0:=:state arg_node:-:B return:-:A	ent0:=:state:::montana:=:state
how many states border on the state whose capital is ent0:=:city ?	add_operation:-:_count add_node:-:B add_type_node:-:_state arg_node:-:B add_node:-:C add_edge:-:_next_to arg_node:-:B arg_node:-:C add_type_node:-:_state arg_node:-:C add_node:-:D add_edge:-:_loc arg_node:-:D arg_node:-:C add_type_node:-:_capital arg_node:-:D add_entity_node:-:ent0:=:city arg_node:-:D end_operation:-:_count ope_for:-:B ope_return:-:A return:-:A	ent0:=:city:::boston:=:city
how many people live in ent0:=:state ?	add_node:-:B add_node:-:A add_edge:-:_population arg_node:-:B arg_node:-:A add_entity_node:-:ent0:=:state arg_node:-:B return:-:A	ent0:=:state:::washington:=:state
what is the largest state capital in population ?	add_operation:-:_largest add_node:-:C add_type_node:-:_state arg_node:-:C add_node:-:A add_edge:-:_capital arg_node:-:C arg_node:-:A add_node:-:B add_edge:-:_population arg_node:-:A arg_node:-:B end_operation:-:arg ope_for:-:B return:-:A	
what is the largest city in states that border ent0:=:state ?	add_operation:-:_largest add_node:-:A add_type_node:-:_city arg_node:-:A add_node:-:B add_edge:-:_loc arg_node:-:A arg_node:-:B add_type_node:-:_state arg_node:-:B add_node:-:C add_edge:-:_next_to arg_node:-:B arg_node:-:C add_entity_node:-:ent0:=:state arg_node:-:C end_operation:-:arg ope_for:-:A return:-:A	ent0:=:state:::california:=:state
what is the most populous city in ent0:=:state ?	add_operation:-:_largest add_node:-:A add_node:-:B add_edge:-:_population arg_node:-:A arg_node:-:B add_type_node:-:_city arg_node:-:A add_node:-:C add_edge:-:_loc arg_node:-:A arg_node:-:C add_entity_node:-:ent0:=:state arg_node:-:C end_operation:-:arg ope_for:-:B return:-:A	ent0:=:state:::wyoming:=:state
what is the population density in the state with capital ent0:=:city ?	add_node:-:B add_node:-:A add_edge:-:_density arg_node:-:B arg_node:-:A add_type_node:-:_state arg_node:-:B add_node:-:C add_edge:-:_loc arg_node:-:C arg_node:-:B add_type_node:-:_capital arg_node:-:C add_entity_node:-:ent0:=:city arg_node:-:C return:-:A	ent0:=:city:::austin:=:city
what is the population of ent0:=:city ?	add_node:-:B add_node:-:A add_edge:-:_population arg_node:-:B arg_node:-:A add_entity_node:-:ent0:=:city arg_node:-:B return:-:A	ent0:=:city:::portland_me:=:city
which state is ent0:=:city in ?	add_node:-:A add_type_node:-:_state arg_node:-:A add_node:-:B add_edge:-:_loc arg_node:-:B arg_node:-:A add_entity_node:-:ent0:=:city arg_node:-:B return:-:A	ent0:=:city:::kalamazoo:=:city
what is the population of the largest state that borders ent0:=:state ?	add_node:-:B add_node:-:A add_edge:-:_population arg_node:-:B arg_node:-:A add_operation:-:_largest add_type_node:-:_state arg_node:-:B add_node:-:C add_edge:-:_next_to arg_node:-:B arg_node:-:C add_entity_node:-:ent0:=:state arg_node:-:C end_operation:-:arg ope_for:-:B return:-:A	ent0:=:state:::texas:=:state
what states border ent0:=:state ?	add_node:-:A add_type_node:-:_state arg_node:-:A add_node:-:B add_edge:-:_next_to arg_node:-:A arg_node:-:B add_entity_node:-:ent0:=:state arg_node:-:B return:-:A	ent0:=:state:::ohio:=:state
what river is the longest one in ent0:=:country ?	add_operation:-:_longest add_node:-:A add_type_node:-:_river arg_node:-:A add_node:-:B add_edge:-:_loc arg_node:-:A arg_node:-:B add_entity_node:-:ent0:=:country arg_node:-:B end_operation:-:arg ope_for:-:A return:-:A	ent0:=:country:::usa:=:country
what is the population density of the state with the smallest area ?	add_node:-:B add_node:-:A add_edge:-:_density arg_node:-:B arg_node:-:A add_operation:-:_smallest add_type_node:-:_state arg_node:-:B add_node:-:C add_edge:-:_area arg_node:-:B arg_node:-:C end_operation:-:arg ope_for:-:C return:-:A	
what is the largest capital ?	add_operation:-:_largest add_node:-:A add_type_node:-:_capital arg_node:-:A end_operation:-:arg ope_for:-:A return:-:A	
what state has the smallest capital ?	add_node:-:A add_type_node:-:_state arg_node:-:A add_node:-:B add_edge:-:_loc arg_node:-:B arg_node:-:A add_operation:-:_smallest add_type_node:-:_capital arg_node:-:B end_operation:-:arg ope_for:-:B return:-:A	
how many big cities are in ent0:=:state ?	add_operation:-:_count add_node:-:B add_type_node:-:_major arg_node:-:B add_type_node:-:_city arg_node:-:B add_node:-:C add_edge:-:_loc arg_node:-:B arg_node:-:C add_entity_node:-:ent0:=:state arg_node:-:C end_operation:-:_count ope_for:-:B ope_return:-:A return:-:A	ent0:=:state:::pennsylvania:=:state
which states lie on the largest river in ent0:=:country ?	add_node:-:A add_type_node:-:_state arg_node:-:A add_node:-:B add_edge:-:_traverse arg_node:-:B arg_node:-:A add_operation:-:_largest add_type_node:-:_river arg_node:-:B add_node:-:C add_edge:-:_loc arg_node:-:B arg_node:-:C add_entity_node:-:ent0:=:country arg_node:-:C end_operation:-:arg ope_for:-:B return:-:A	ent0:=:country:::usa:=:country
where is ent0:=:city ?	add_node:-:B add_node:-:A add_edge:-:_loc arg_node:-:B arg_node:-:A add_entity_node:-:ent0:=:city arg_node:-:B return:-:A	ent0:=:city:::houston:=:city
what rivers flow through states that border the state with the largest population ?	add_node:-:A add_type_node:-:_river arg_node:-:A add_node:-:B add_edge:-:_traverse arg_node:-:A arg_node:-:B add_type_node:-:_state arg_node:-:B add_node:-:C add_edge:-:_next_to arg_node:-:B arg_node:-:C add_operation:-:_largest add_type_node:-:_state arg_node:-:C add_node:-:D add_edge:-:_population arg_node:-:C arg_node:-:D end_operation:-:arg ope_for:-:D return:-:A	
what is the highest point in the smallest state ?	add_operation:-:_highest add_node:-:A add_type_node:-:_place arg_node:-:A add_node:-:B add_edge:-:_loc arg_node:-:A arg_node:-:B add_operation:-:_smallest add_type_node:-:_state arg_node:-:B end_operation:-:arg ope_for:-:B end_operation:-:arg ope_for:-:A return:-:A	
what river runs through ent0:=:state ?	add_node:-:A add_type_node:-:_river arg_node:-:A add_node:-:B add_edge:-:_traverse arg_node:-:A arg_node:-:B add_entity_node:-:ent0:=:state arg_node:-:B return:-:A	ent0:=:state:::virginia:=:state
what state borders ent0:=:state ?	add_node:-:A add_type_node:-:_state arg_node:-:A add_node:-:B add_edge:-:_next_to arg_node:-:A arg_node:-:B add_entity_node:-:ent0:=:state arg_node:-:B return:-:A	ent0:=:state:::michigan:=:state
name the major lakes in ent0:=:state ?	add_node:-:A add_type_node:-:_major arg_node:-:A add_type_node:-:_lake arg_node:-:A add_node:-:B add_edge:-:_loc arg_node:-:A arg_node:-:B add_entity_node:-:ent0:=:state arg_node:-:B return:-:A	ent0:=:state:::michigan:=:state
give me the cities in ent0:=:state ?	add_node:-:A add_type_node:-:_city arg_node:-:A add_node:-:B add_edge:-:_loc arg_node:-:A arg_node:-:B add_entity_node:-:ent0:=:state arg_node:-:B return:-:A	ent0:=:state:::virginia:=:state
which river runs through the most states ?	add_operation:-:_most add_node:-:A add_type_node:-:_river arg_node:-:A add_node:-:B add_edge:-:_traverse arg_node:-:A arg_node:-:B add_type_node:-:_state arg_node:-:B end_operation:-:arg_count ope_for:-:A ope_for:-:B return:-:A	
how many people live in ent0:=:state ?	add_node:-:B add_node:-:A add_edge:-:_population arg_node:-:B arg_node:-:A add_entity_node:-:ent0:=:state arg_node:-:B return:-:A	ent0:=:state:::new_mexico:=:state
what is the largest city in ent0:=:state ?	add_operation:-:_largest add_node:-:A add_type_node:-:_city arg_node:-:A add_node:-:B add_edge:-:_loc arg_node:-:A arg_node:-:B add_entity_node:-:ent0:=:state arg_node:-:B end_operation:-:arg ope_for:-:A return:-:A	ent0:=:state:::alabama:=:state
how many people live in ent0:=:city ?	add_node:-:B add_node:-:A add_edge:-:_population arg_node:-:B arg_node:-:A add_entity_node:-:ent0:=:city arg_node:-:B return:-:A	ent0:=:city:::san_francisco:=:city
what is the population of the capital of the largest state ?	add_node:-:B add_node:-:A add_edge:-:_population arg_node:-:B arg_node:-:A add_type_node:-:_capital arg_node:-:B add_node:-:C add_edge:-:_loc arg_node:-:B arg_node:-:C add_operation:-:_largest add_type_node:-:_state arg_node:-:C end_operation:-:arg ope_for:-:C return:-:A	
what is the longest river in ent0:=:country ?	add_operation:-:_longest add_node:-:A add_type_node:-:_river arg_node:-:A add_node:-:B add_edge:-:_loc arg_node:-:A arg_node:-:B add_entity_node:-:ent0:=:country arg_node:-:B end_operation:-:arg ope_for:-:A return:-:A	ent0:=:country:::usa:=:country
what is the largest state that borders the state with the highest population ?	add_operation:-:_largest add_node:-:A add_type_node:-:_state arg_node:-:A add_node:-:B add_edge:-:_next_to arg_node:-:A arg_node:-:B add_operation:-:_largest add_type_node:-:_state arg_node:-:B add_node:-:C add_edge:-:_population arg_node:-:B arg_node:-:C end_operation:-:arg ope_for:-:C end_operation:-:arg ope_for:-:A return:-:A	
show me all the major lakes in ent0:=:country ?	add_node:-:A add_type_node:-:_major arg_node:-:A add_type_node:-:_lake arg_node:-:A add_node:-:B add_edge:-:_loc arg_node:-:A arg_node:-:B add_entity_node:-:ent0:=:country arg_node:-:B return:-:A	ent0:=:country:::usa:=:country
where is ent0:=:city ?	add_node:-:B add_node:-:A add_edge:-:_loc arg_node:-:B arg_node:-:A add_entity_node:-:ent0:=:city arg_node:-:B return:-:A	ent0:=:city:::springfield:=:city
what state is ent0:=:city located in ?	add_node:-:A add_type_node:-:_state arg_node:-:A add_node:-:B add_edge:-:_loc arg_node:-:B arg_node:-:A add_entity_node:-:ent0:=:city arg_node:-:B return:-:A	ent0:=:city:::des_moines:=:city
how many cities does ent0:=:state have ?	add_operation:-:_count add_node:-:B add_type_node:-:_city arg_node:-:B add_node:-:C add_edge:-:_loc arg_node:-:B arg_node:-:C add_entity_node:-:ent0:=:state arg_node:-:C end_operation:-:_count ope_for:-:B ope_return:-:A return:-:A	ent0:=:state:::texas:=:state
what state is ent0:=:city in ?	add_node:-:A add_type_node:-:_state arg_node:-:A add_node:-:B add_edge:-:_loc arg_node:-:B arg_node:-:A add_entity_node:-:ent0:=:city arg_node:-:B return:-:A	ent0:=:city:::boston:=:city
which rivers run through the state with the largest city in ent0:=:country ?	add_node:-:A add_type_node:-:_river arg_node:-:A add_node:-:B add_edge:-:_traverse arg_node:-:A arg_node:-:B add_operation:-:_largest add_type_node:-:_state arg_node:-:B add_node:-:C add_edge:-:_loc arg_node:-:C arg_node:-:B add_type_node:-:_city arg_node:-:C add_node:-:D add_edge:-:_loc arg_node:-:C arg_node:-:D add_entity_node:-:ent0:=:country arg_node:-:D end_operation:-:arg ope_for:-:C return:-:A	ent0:=:country:::usa:=:country
states bordering ent0:=:state ?	add_node:-:A add_type_node:-:_state arg_node:-:A add_node:-:B add_edge:-:_next_to arg_node:-:A arg_node:-:B add_entity_node:-:ent0:=:state arg_node:-:B return:-:A	ent0:=:state:::iowa:=:state
what states have no bordering state ?	add_node:-:A add_type_node:-:_state arg_node:-:A add_operation:-:_not add_node:-:B add_edge:-:_next_to arg_node:-:A arg_node:-:B add_type_node:-:_state arg_node:-:B end_operation:-:_not return:-:A	
where is the lowest point in ent0:=:country ?	add_operation:-:_lowest add_node:-:A add_type_node:-:_place arg_node:-:A add_node:-:B add_edge:-:_loc arg_node:-:A arg_node:-:B add_entity_node:-:ent0:=:country arg_node:-:B end_operation:-:arg ope_for:-:A return:-:A	ent0:=:country:::usa:=:country
what are the major cities in ent0:=:state ?	add_node:-:A add_type_node:-:_major arg_node:-:A add_type_node:-:_city arg_node:-:A add_node:-:B add_edge:-:_loc arg_node:-:A arg_node:-:B add_entity_node:-:ent0:=:state arg_node:-:B return:-:A	ent0:=:state:::oklahoma:=:state
which state has the smallest area that borders ent0:=:state ?	add_operation:-:_smallest add_node:-:A add_type_node:-:_state arg_node:-:A add_node:-:B add_edge:-:_area arg_node:-:A arg_node:-:B add_node:-:C add_edge:-:_next_to arg_node:-:A arg_node:-:C add_entity_node:-:ent0:=:state arg_node:-:C end_operation:-:arg ope_for:-:B return:-:A	ent0:=:state:::texas:=:state
what is the capital of the state with the highest elevation ?	add_node:-:A add_type_node:-:_capital arg_node:-:A add_node:-:B add_edge:-:_loc arg_node:-:A arg_node:-:B add_type_node:-:_state arg_node:-:B add_node:-:C add_edge:-:_loc arg_node:-:C arg_node:-:B add_operation:-:_highest add_type_node:-:_place arg_node:-:C end_operation:-:arg ope_for:-:C return:-:A	
what states does ent0:=:river run through ?	add_node:-:A add_type_node:-:_state arg_node:-:A add_node:-:B add_edge:-:_traverse arg_node:-:B arg_node:-:A add_entity_node:-:ent0:=:river arg_node:-:B return:-:A	ent0:=:river:::mississippi:=:river
where is ent0:=:place located ?	add_node:-:B add_node:-:A add_edge:-:_loc arg_node:-:B arg_node:-:A add_entity_node:-:ent0:=:place arg_node:-:B return:-:A	ent0:=:place:::mount_whitney:=:place
which state has the largest density ?	add_operation:-:_largest add_node:-:A add_type_node:-:_state arg_node:-:A add_node:-:B add_edge:-:_density arg_node:-:A arg_node:-:B end_operation:-:arg ope_for:-:B return:-:A	
what is the smallest city in ent0:=:state ?	add_operation:-:_smallest add_node:-:A add_type_node:-:_city arg_node:-:A add_node:-:B add_edge:-:_loc arg_node:-:A arg_node:-:B add_entity_node:-:ent0:=:state arg_node:-:B end_operation:-:arg ope_for:-:A return:-:A	ent0:=:state:::washington:=:state
what are the major cities in ent0:=:state ?	add_node:-:A add_type_node:-:_major arg_node:-:A add_type_node:-:_city arg_node:-:A add_node:-:B add_edge:-:_loc arg_node:-:A arg_node:-:B add_entity_node:-:ent0:=:state arg_node:-:B return:-:A	ent0:=:state:::new_mexico:=:state
how many people live in the capital of ent0:=:state ?	add_node:-:B add_node:-:A add_edge:-:_population arg_node:-:B arg_node:-:A add_type_node:-:_capital arg_node:-:B add_node:-:C add_edge:-:_loc arg_node:-:B arg_node:-:C add_entity_node:-:ent0:=:state arg_node:-:C return:-:A	ent0:=:state:::georgia:=:state
what state which ent0:=:river runs through has the largest population ?	add_operation:-:_largest add_node:-:A add_type_node:-:_state arg_node:-:A add_node:-:C add_edge:-:_traverse arg_node:-:C arg_node:-:A add_node:-:B add_edge:-:_population arg_node:-:A arg_node:-:B add_entity_node:-:ent0:=:river arg_node:-:C end_operation:-:arg ope_for:-:B return:-:A	ent0:=:river:::mississippi:=:river
state the state with the largest area ?	add_node:-:A add_type_node:-:_state arg_node:-:A add_operation:-:_largest add_type_node:-:_state arg_node:-:A add_node:-:B add_edge:-:_area arg_node:-:A arg_node:-:B end_operation:-:arg ope_for:-:B return:-:A	
how many people live in ent0:=:city ?	add_node:-:B add_node:-:A add_edge:-:_population arg_node:-:B arg_node:-:A add_entity_node:-:ent0:=:city arg_node:-:B return:-:A	ent0:=:city:::riverside:=:city
what is the area of ent0:=:city ?	add_node:-:B add_node:-:A add_edge:-:_area arg_node:-:B arg_node:-:A add_entity_node:-:ent0:=:city arg_node:-:B return:-:A	ent0:=:city:::seattle:=:city
what capital has the largest population ?	add_operation:-:_largest add_node:-:A add_type_node:-:_capital arg_node:-:A add_node:-:B add_edge:-:_population arg_node:-:A arg_node:-:B end_operation:-:arg ope_for:-:B return:-:A	
what is the capital of the state that borders the most states ?	add_node:-:A add_type_node:-:_capital arg_node:-:A add_node:-:B add_edge:-:_loc arg_node:-:A arg_node:-:B add_operation:-:_most add_type_node:-:_state arg_node:-:B add_node:-:C add_edge:-:_next_to arg_node:-:B arg_node:-:C add_type_node:-:_state arg_node:-:C end_operation:-:arg_count ope_for:-:B ope_for:-:C return:-:A	
how many rivers run through the states bordering ent0:=:state ?	add_operation:-:_count add_node:-:B add_type_node:-:_river arg_node:-:B add_node:-:C add_edge:-:_traverse arg_node:-:B arg_node:-:C add_type_node:-:_state arg_node:-:C add_node:-:D add_edge:-:_next_to arg_node:-:C arg_node:-:D add_entity_node:-:ent0:=:state arg_node:-:D end_operation:-:_count ope_for:-:B ope_return:-:A return:-:A	ent0:=:state:::colorado:=:state
what are the cities in ent0:=:state ?	add_node:-:A add_type_node:-:_city arg_node:-:A add_node:-:B add_edge:-:_loc arg_node:-:A arg_node:-:B add_entity_node:-:ent0:=:state arg_node:-:B return:-:A	ent0:=:state:::california:=:state
what state is ent0:=:city the capital of ?	add_node:-:A add_type_node:-:_state arg_node:-:A add_node:-:B add_edge:-:_loc arg_node:-:B arg_node:-:A add_entity_node:-:ent0:=:city arg_node:-:B add_type_node:-:_capital arg_node:-:B return:-:A	ent0:=:city:::austin:=:city
how many people live in ent0:=:state ?	add_node:-:B add_node:-:A add_edge:-:_population arg_node:-:B arg_node:-:A add_entity_node:-:ent0:=:state arg_node:-:B return:-:A	ent0:=:state:::kansas:=:state
what state borders the least states ?	add_operation:-:_fewest add_node:-:A add_type_node:-:_state arg_node:-:A add_node:-:B add_edge:-:_next_to arg_node:-:A arg_node:-:B add_type_node:-:_state arg_node:-:B end_operation:-:arg_count ope_for:-:A ope_for:-:B return:-:A	
which states border ent0:=:state ?	add_node:-:A add_type_node:-:_state arg_node:-:A add_node:-:B add_edge:-:_next_to arg_node:-:A arg_node:-:B add_entity_node:-:ent0:=:state arg_node:-:B return:-:A	ent0:=:state:::south_dakota:=:state
name the rivers in ent0:=:state ?	add_node:-:A add_type_node:-:_river arg_node:-:A add_node:-:B add_edge:-:_loc arg_node:-:A arg_node:-:B add_entity_node:-:ent0:=:state arg_node:-:B return:-:A	ent0:=:state:::arkansas:=:state
how long is ent0:=:river in miles ?	add_node:-:B add_node:-:A add_edge:-:_len arg_node:-:B arg_node:-:A add_entity_node:-:ent0:=:river arg_node:-:B add_type_node:-:_river arg_node:-:B return:-:A	ent0:=:river:::mississippi:=:river
what is the shortest river in ent0:=:country ?	add_operation:-:_shortest add_node:-:A add_type_node:-:_river arg_node:-:A add_node:-:B add_edge:-:_loc arg_node:-:A arg_node:-:B add_entity_node:-:ent0:=:country arg_node:-:B end_operation:-:arg ope_for:-:A return:-:A	ent0:=:country:::usa:=:country
what is the biggest city in ent0:=:country ?	add_operation:-:_largest add_node:-:A add_type_node:-:_city arg_node:-:A add_node:-:B add_edge:-:_loc arg_node:-:A arg_node:-:B add_entity_node:-:ent0:=:country arg_node:-:B end_operation:-:arg ope_for:-:A return:-:A	ent0:=:country:::usa:=:country
what is the capital of ent0:=:state ?	add_node:-:A add_type_node:-:_capital arg_node:-:A add_node:-:B add_edge:-:_loc arg_node:-:A arg_node:-:B add_entity_node:-:ent0:=:state arg_node:-:B return:-:A	ent0:=:state:::washington:=:state
how many cities are in ent0:=:state ?	add_operation:-:_count add_node:-:B add_type_node:-:_city arg_node:-:B add_node:-:C add_edge:-:_loc arg_node:-:B arg_node:-:C add_entity_node:-:ent0:=:state arg_node:-:C end_operation:-:_count ope_for:-:B ope_return:-:A return:-:A	ent0:=:state:::montana:=:state
what is the capital of the state ent0:=:state ?	add_node:-:A add_type_node:-:_capital arg_node:-:A add_node:-:B add_edge:-:_loc arg_node:-:A arg_node:-:B add_type_node:-:_state arg_node:-:B add_entity_node:-:ent0:=:state arg_node:-:B return:-:A	ent0:=:state:::texas:=:state
what is the height of ent0:=:place ?	add_node:-:B add_node:-:A add_edge:-:_elevation arg_node:-:B arg_node:-:A add_entity_node:-:ent0:=:place arg_node:-:B return:-:A	ent0:=:place:::mount_mckinley:=:place
what is the city with the smallest population ?	add_operation:-:_smallest add_node:-:A add_type_node:-:_city arg_node:-:A add_node:-:B add_edge:-:_population arg_node:-:A arg_node:-:B end_operation:-:arg ope_for:-:B return:-:A	
what is the biggest state in ent0:=:country ?	add_operation:-:_largest add_node:-:A add_type_node:-:_state arg_node:-:A add_node:-:B add_edge:-:_loc arg_node:-:A arg_node:-:B add_entity_node:-:ent0:=:country arg_node:-:B end_operation:-:arg ope_for:-:A return:-:A	ent0:=:country:::usa:=:country
how many major cities are in states bordering ent0:=:state ?	add_operation:-:_count add_node:-:B add_type_node:-:_major arg_node:-:B add_type_node:-:_city arg_node:-:B add_node:-:C add_edge:-:_loc arg_node:-:B arg_node:-:C add_type_node:-:_state arg_node:-:C add_node:-:D add_edge:-:_next_to arg_node:-:C arg_node:-:D add_entity_node:-:ent0:=:state arg_node:-:D end_operation:-:_count ope_for:-:B ope_return:-:A return:-:A	ent0:=:state:::utah:=:state
how many states border ent0:=:state ?	add_operation:-:_count add_node:-:B add_type_node:-:_state arg_node:-:B add_node:-:C add_edge:-:_next_to arg_node:-:B arg_node:-:C add_entity_node:-:ent0:=:state arg_node:-:C end_operation:-:_count ope_for:-:B ope_return:-:A return:-:A	ent0:=:state:::tennessee:=:state
what states does ent0:=:river go through ?	add_node:-:A add_type_node:-:_state arg_node:-:A add_node:-:B add_edge:-:_traverse arg_node:-:B arg_node:-:A add_entity_node:-:ent0:=:river arg_node:-:B add_type_node:-:_river arg_node:-:B return:-:A	ent0:=:river:::ohio:=:river
what is the longest river in the smallest state in ent0:=:country ?	add_operation:-:_longest add_node:-:A add_type_node:-:_river arg_node:-:A add_node:-:B add_edge:-:_loc arg_node:-:A arg_node:-:B add_operation:-:_smallest add_type_node:-:_state arg_node:-:B add_node:-:C add_edge:-:_loc arg_node:-:B arg_node:-:C add_entity_node:-:ent0:=:country arg_node:-:C end_operation:-:arg ope_for:-:B end_operation:-:arg ope_for:-:A return:-:A	ent0:=:country:::usa:=:country
what is the smallest state by area ?	add_operation:-:_smallest add_node:-:A add_type_node:-:_state arg_node:-:A add_node:-:B add_edge:-:_area arg_node:-:A arg_node:-:B end_operation:-:arg ope_for:-:B return:-:A	
what is the population of the capital of the largest state through which ent0:=:river runs ?	add_node:-:B add_node:-:A add_edge:-:_population arg_node:-:B arg_node:-:A add_type_node:-:_capital arg_node:-:B add_node:-:C add_edge:-:_loc arg_node:-:B arg_node:-:C add_operation:-:_largest add_type_node:-:_state arg_node:-:C add_node:-:D add_edge:-:_traverse arg_node:-:D arg_node:-:C add_entity_node:-:ent0:=:river arg_node:-:D end_operation:-:arg ope_for:-:C return:-:A	ent0:=:river:::mississippi:=:river
what is the population of ent0:=:city ?	add_node:-:B add_node:-:A add_edge:-:_population arg_node:-:B arg_node:-:A add_entity_node:-:ent0:=:city arg_node:-:B return:-:A	ent0:=:city:::boston_ma:=:city
what cities in ent0:=:state ?	add_node:-:A add_type_node:-:_city arg_node:-:A add_node:-:B add_edge:-:_loc arg_node:-:A arg_node:-:B add_entity_node:-:ent0:=:state arg_node:-:B return:-:A	ent0:=:state:::california:=:state
how big is the ent0:=:city ?	add_node:-:B add_node:-:A add_edge:-:_size arg_node:-:B arg_node:-:A add_entity_node:-:ent0:=:city arg_node:-:B return:-:A	ent0:=:city:::new_york:=:city
what state has the most cities ?	add_operation:-:_most add_node:-:A add_type_node:-:_state arg_node:-:A add_node:-:B add_edge:-:_loc arg_node:-:B arg_node:-:A add_type_node:-:_city arg_node:-:B end_operation:-:arg_count ope_for:-:A ope_for:-:B return:-:A	
what is the longest river ?	add_operation:-:_longest add_node:-:A add_type_node:-:_river arg_node:-:A end_operation:-:arg ope_for:-:A return:-:A	
name the 50 capitals in ent0:=:country ?	add_node:-:A add_type_node:-:_capital arg_node:-:A add_node:-:B add_edge:-:_loc arg_node:-:A arg_node:-:B add_entity_node:-:ent0:=:country arg_node:-:B return:-:A	ent0:=:country:::usa:=:country
what is the capital of the state that borders the state that borders ent0:=:state ?	add_node:-:A add_type_node:-:_capital arg_node:-:A add_node:-:B add_edge:-:_loc arg_node:-:A arg_node:-:B add_type_node:-:_state arg_node:-:B add_node:-:C add_edge:-:_next_to arg_node:-:B arg_node:-:C add_type_node:-:_state arg_node:-:C add_node:-:D add_edge:-:_next_to arg_node:-:C arg_node:-:D add_entity_node:-:ent0:=:state arg_node:-:D return:-:A	ent0:=:state:::texas:=:state
which state has ent0:=:river river ?	add_node:-:A add_type_node:-:_state arg_node:-:A add_node:-:B add_edge:-:_loc arg_node:-:B arg_node:-:A add_entity_node:-:ent0:=:river arg_node:-:B add_type_node:-:_river arg_node:-:B return:-:A	ent0:=:river:::red:=:river
how many people live in ent0:=:city ?	add_node:-:B add_node:-:A add_edge:-:_population arg_node:-:B arg_node:-:A add_entity_node:-:ent0:=:city arg_node:-:B return:-:A	ent0:=:city:::chicago:=:city
what is the smallest city in ent0:=:state ?	add_operation:-:_smallest add_node:-:A add_type_node:-:_city arg_node:-:A add_node:-:B add_edge:-:_loc arg_node:-:A arg_node:-:B add_entity_node:-:ent0:=:state arg_node:-:B end_operation:-:arg ope_for:-:A return:-:A	ent0:=:state:::alaska:=:state
list the states ?	add_node:-:A add_type_node:-:_state arg_node:-:A return:-:A	
what is the biggest city in ent0:=:state ?	add_operation:-:_largest add_node:-:A add_type_node:-:_city arg_node:-:A add_node:-:B add_edge:-:_loc arg_node:-:A arg_node:-:B add_entity_node:-:ent0:=:state arg_node:-:B end_operation:-:arg ope_for:-:A return:-:A	ent0:=:state:::georgia:=:state
what states border states which ent0:=:river runs through ?	add_node:-:A add_type_node:-:_state arg_node:-:A add_node:-:B add_edge:-:_next_to arg_node:-:A arg_node:-:B add_type_node:-:_state arg_node:-:B add_node:-:C add_edge:-:_traverse arg_node:-:C arg_node:-:B add_entity_node:-:ent0:=:river arg_node:-:C return:-:A	ent0:=:river:::mississippi:=:river
how many cities are there in ent0:=:country ?	add_operation:-:_count add_node:-:B add_type_node:-:_city arg_node:-:B add_node:-:C add_edge:-:_loc arg_node:-:B arg_node:-:C add_entity_node:-:ent0:=:country arg_node:-:C end_operation:-:_count ope_for:-:B ope_return:-:A return:-:A	ent0:=:country:::usa:=:country
how big is ent0:=:state ?	add_node:-:B add_node:-:A add_edge:-:_size arg_node:-:B arg_node:-:A add_entity_node:-:ent0:=:state arg_node:-:B return:-:A	ent0:=:state:::texas:=:state
what is the height of the highest point in ent0:=:country ?	add_node:-:B add_node:-:A add_edge:-:_elevation arg_node:-:B arg_node:-:A add_operation:-:_highest add_type_node:-:_place arg_node:-:B add_node:-:C add_edge:-:_loc arg_node:-:B arg_node:-:C add_entity_node:-:ent0:=:country arg_node:-:C end_operation:-:arg ope_for:-:B return:-:A	ent0:=:country:::usa:=:country
what are the populations of the states through which ent0:=:river runs ?	add_node:-:B add_node:-:A add_edge:-:_population arg_node:-:B arg_node:-:A add_type_node:-:_state arg_node:-:B add_node:-:C add_edge:-:_traverse arg_node:-:C arg_node:-:B add_entity_node:-:ent0:=:river arg_node:-:C return:-:A	ent0:=:river:::mississippi:=:river
what state has the smallest population ?	add_operation:-:_smallest add_node:-:A add_type_node:-:_state arg_node:-:A add_node:-:B add_edge:-:_population arg_node:-:A arg_node:-:B end_operation:-:arg ope_for:-:B return:-:A	
how many states border ent0:=:state ?	add_operation:-:_count add_node:-:B add_type_node:-:_state arg_node:-:B add_node:-:C add_edge:-:_next_to arg_node:-:B arg_node:-:C add_entity_node:-:ent0:=:state arg_node:-:C end_operation:-:_count ope_for:-:B ope_return:-:A return:-:A	ent0:=:state:::texas:=:state
which states do ent0:=:river flow through ?	add_node:-:A add_type_node:-:_state arg_node:-:A add_node:-:B add_edge:-:_traverse arg_node:-:B arg_node:-:A add_entity_node:-:ent0:=:river arg_node:-:B add_type_node:-:_river arg_node:-:B return:-:A	ent0:=:river:::colorado:=:river
what is the highest point in ent0:=:state ?	add_operation:-:_highest add_node:-:A add_type_node:-:_place arg_node:-:A add_node:-:B add_edge:-:_loc arg_node:-:A arg_node:-:B add_entity_node:-:ent0:=:state arg_node:-:B end_operation:-:arg ope_for:-:A return:-:A	ent0:=:state:::texas:=:state
what is the longest river in ent0:=:state ?	add_operation:-:_longest add_node:-:A add_type_node:-:_river arg_node:-:A add_node:-:B add_edge:-:_loc arg_node:-:A arg_node:-:B add_entity_node:-:ent0:=:state arg_node:-:B end_operation:-:arg ope_for:-:A return:-:A	ent0:=:state:::california:=:state
what is the length of the river that runs through the most number of states ?	add_node:-:B add_node:-:A add_edge:-:_len arg_node:-:B arg_node:-:A add_operation:-:_most add_type_node:-:_river arg_node:-:B add_node:-:C add_edge:-:_traverse arg_node:-:B arg_node:-:C add_type_node:-:_state arg_node:-:C end_operation:-:arg_count ope_for:-:B ope_for:-:C return:-:A	
what is the most populous state in ent0:=:country ?	add_operation:-:_largest add_node:-:A add_node:-:B add_edge:-:_population arg_node:-:A arg_node:-:B add_type_node:-:_state arg_node:-:A add_node:-:C add_edge:-:_loc arg_node:-:A arg_node:-:C add_entity_node:-:ent0:=:country arg_node:-:C end_operation:-:arg ope_for:-:B return:-:A	ent0:=:country:::usa:=:country
what is the capital of ent0:=:state ?	add_node:-:A add_type_node:-:_capital arg_node:-:A add_node:-:B add_edge:-:_loc arg_node:-:A arg_node:-:B add_entity_node:-:ent0:=:state arg_node:-:B return:-:A	ent0:=:state:::georgia:=:state
what is the average population of ent0:=:country by state ?	add_node:-:B add_node:-:A add_edge:-:_density arg_node:-:B arg_node:-:A add_entity_node:-:ent0:=:country arg_node:-:B return:-:A	ent0:=:country:::usa:=:country
what is the area of ent0:=:state ?	add_node:-:B add_node:-:A add_edge:-:_area arg_node:-:B arg_node:-:A add_entity_node:-:ent0:=:state arg_node:-:B return:-:A	ent0:=:state:::new_mexico:=:state
what is the longest river in ent0:=:state ?	add_operation:-:_longest add_node:-:A add_type_node:-:_river arg_node:-:A add_node:-:B add_edge:-:_loc arg_node:-:A arg_node:-:B add_entity_node:-:ent0:=:state arg_node:-:B end_operation:-:arg ope_for:-:A return:-:A	ent0:=:state:::texas:=:state
how many major cities are there ?	add_operation:-:_count add_node:-:B add_type_node:-:_major arg_node:-:B add_type_node:-:_city arg_node:-:B end_operation:-:_count ope_for:-:B ope_return:-:A return:-:A	
how many rivers are in the state with the largest population ?	add_operation:-:_count add_node:-:B add_type_node:-:_river arg_node:-:B add_node:-:C add_edge:-:_loc arg_node:-:B arg_node:-:C add_operation:-:_largest add_type_node:-:_state arg_node:-:C add_node:-:D add_edge:-:_population arg_node:-:C arg_node:-:D end_operation:-:arg ope_for:-:D end_operation:-:_count ope_for:-:B ope_return:-:A return:-:A	
what is the major cities in ent0:=:state ?	add_node:-:A add_type_node:-:_major arg_node:-:A add_type_node:-:_city arg_node:-:A add_node:-:B add_edge:-:_loc arg_node:-:A arg_node:-:B add_entity_node:-:ent0:=:state arg_node:-:B return:-:A	ent0:=:state:::montana:=:state
what is the population of the major cities in ent0:=:state ?	add_node:-:B add_node:-:A add_edge:-:_population arg_node:-:B arg_node:-:A add_type_node:-:_major arg_node:-:B add_type_node:-:_city arg_node:-:B add_node:-:C add_edge:-:_loc arg_node:-:B arg_node:-:C add_entity_node:-:ent0:=:state arg_node:-:C return:-:A	ent0:=:state:::wisconsin:=:state
which states does not border ent0:=:state ?	add_node:-:A add_type_node:-:_state arg_node:-:A add_operation:-:_not add_node:-:B add_edge:-:_next_to arg_node:-:A arg_node:-:B add_entity_node:-:ent0:=:state arg_node:-:B end_operation:-:_not return:-:A	ent0:=:state:::texas:=:state
what river traverses the most states ?	add_operation:-:_most add_node:-:A add_type_node:-:_river arg_node:-:A add_node:-:B add_edge:-:_traverse arg_node:-:A arg_node:-:B add_type_node:-:_state arg_node:-:B end_operation:-:arg_count ope_for:-:A ope_for:-:B return:-:A	
what is the state with the lowest population density ?	add_operation:-:_smallest add_node:-:A add_type_node:-:_state arg_node:-:A add_node:-:B add_edge:-:_density arg_node:-:A arg_node:-:B end_operation:-:arg ope_for:-:B return:-:A	
what states does ent0:=:river run through ?	add_node:-:A add_type_node:-:_state arg_node:-:A add_node:-:B add_edge:-:_traverse arg_node:-:B arg_node:-:A add_entity_node:-:ent0:=:river arg_node:-:B add_type_node:-:_river arg_node:-:B return:-:A	ent0:=:river:::missouri:=:river
how many rivers are in ent0:=:state ?	add_operation:-:_count add_node:-:B add_type_node:-:_river arg_node:-:B add_node:-:C add_edge:-:_loc arg_node:-:B arg_node:-:C add_entity_node:-:ent0:=:state arg_node:-:C end_operation:-:_count ope_for:-:B ope_return:-:A return:-:A	ent0:=:state:::colorado:=:state
what is the shortest river in ent0:=:state ?	add_operation:-:_shortest add_node:-:A add_type_node:-:_river arg_node:-:A add_node:-:B add_edge:-:_loc arg_node:-:A arg_node:-:B add_entity_node:-:ent0:=:state arg_node:-:B end_operation:-:arg ope_for:-:A return:-:A	ent0:=:state:::iowa:=:state
what states border states that ent0:=:river runs through ?	add_node:-:A add_type_node:-:_state arg_node:-:A add_node:-:B add_edge:-:_next_to arg_node:-:A arg_node:-:B add_type_node:-:_state arg_node:-:B add_node:-:C add_edge:-:_traverse arg_node:-:C arg_node:-:B add_entity_node:-:ent0:=:river arg_node:-:C return:-:A	ent0:=:river:::mississippi:=:river
how many people are there in ent0:=:state ?	add_node:-:B add_node:-:A add_edge:-:_population arg_node:-:B arg_node:-:A add_entity_node:-:ent0:=:state arg_node:-:B return:-:A	ent0:=:state:::new_york:=:state
what is the city in ent0:=:state with the largest population ?	add_operation:-:_largest add_node:-:A add_type_node:-:_city arg_node:-:A add_node:-:C add_edge:-:_loc arg_node:-:A arg_node:-:C add_entity_node:-:ent0:=:state arg_node:-:C add_node:-:B add_edge:-:_population arg_node:-:A arg_node:-:B end_operation:-:arg ope_for:-:B return:-:A	ent0:=:state:::texas:=:state
what is the highest elevation in ent0:=:state ?	add_operation:-:_highest add_node:-:A add_type_node:-:_place arg_node:-:A add_node:-:B add_edge:-:_loc arg_node:-:A arg_node:-:B add_entity_node:-:ent0:=:state arg_node:-:B end_operation:-:arg ope_for:-:A return:-:A	ent0:=:state:::new_mexico:=:state
what is the highest point in ent0:=:country ?	add_operation:-:_highest add_node:-:A add_type_node:-:_place arg_node:-:A add_node:-:B add_edge:-:_loc arg_node:-:A arg_node:-:B add_entity_node:-:ent0:=:country arg_node:-:B end_operation:-:arg ope_for:-:A return:-:A	ent0:=:country:::usa:=:country
what is the population of the state with the largest area ?	add_node:-:B add_node:-:A add_edge:-:_population arg_node:-:B arg_node:-:A add_operation:-:_largest add_type_node:-:_state arg_node:-:B add_node:-:C add_edge:-:_area arg_node:-:B arg_node:-:C end_operation:-:arg ope_for:-:C return:-:A	
where is ent0:=:city ?	add_node:-:B add_node:-:A add_edge:-:_loc arg_node:-:B arg_node:-:A add_entity_node:-:ent0:=:city arg_node:-:B return:-:A	ent0:=:city:::baton_rouge:=:city
what states in ent0:=:country have a ent0:=:city ?	add_node:-:A add_type_node:-:_state arg_node:-:A add_node:-:B add_edge:-:_loc arg_node:-:A arg_node:-:B add_entity_node:-:ent0:=:country arg_node:-:B add_node:-:C add_edge:-:_loc arg_node:-:C arg_node:-:A add_entity_node:-:ent0:=:city arg_node:-:C return:-:A	ent0:=:country:::usa:=:country ent0:=:city:::springfield:=:city
how many cities are in ent0:=:state ?	add_operation:-:_count add_node:-:B add_type_node:-:_city arg_node:-:B add_node:-:C add_edge:-:_loc arg_node:-:B arg_node:-:C add_entity_node:-:ent0:=:state arg_node:-:C end_operation:-:_count ope_for:-:B ope_return:-:A return:-:A	ent0:=:state:::louisiana:=:state
how many states are in ent0:=:country ?	add_operation:-:_count add_node:-:B add_type_node:-:_state arg_node:-:B add_node:-:C add_edge:-:_loc arg_node:-:B arg_node:-:C add_entity_node:-:ent0:=:country arg_node:-:C end_operation:-:_count ope_for:-:B ope_return:-:A return:-:A	ent0:=:country:::usa:=:country
what rivers run through ent0:=:state ?	add_node:-:A add_type_node:-:_river arg_node:-:A add_node:-:B add_edge:-:_traverse arg_node:-:A arg_node:-:B add_entity_node:-:ent0:=:state arg_node:-:B return:-:A	ent0:=:state:::louisiana:=:state
how many people live in the state with the largest population density ?	add_node:-:B add_node:-:A add_edge:-:_population arg_node:-:B arg_node:-:A add_operation:-:_largest add_type_node:-:_state arg_node:-:B add_node:-:C add_edge:-:_density arg_node:-:B arg_node:-:C end_operation:-:arg ope_for:-:C return:-:A	
what is the state with the highest elevation in ent0:=:country ?	add_node:-:A add_type_node:-:_state arg_node:-:A add_node:-:B add_edge:-:_loc arg_node:-:B arg_node:-:A add_operation:-:_highest add_type_node:-:_place arg_node:-:B add_node:-:C add_edge:-:_loc arg_node:-:B arg_node:-:C add_entity_node:-:ent0:=:country arg_node:-:C end_operation:-:arg ope_for:-:B return:-:A	ent0:=:country:::usa:=:country
what state borders most other states ?	add_operation:-:_most add_node:-:A add_type_node:-:_state arg_node:-:A add_node:-:B add_edge:-:_next_to arg_node:-:A arg_node:-:B add_type_node:-:_state arg_node:-:B end_operation:-:arg_count ope_for:-:A ope_for:-:B return:-:A	
which states adjoin ent0:=:state ?	add_node:-:A add_type_node:-:_state arg_node:-:A add_node:-:B add_edge:-:_next_to arg_node:-:A arg_node:-:B add_entity_node:-:ent0:=:state arg_node:-:B return:-:A	ent0:=:state:::alabama:=:state
what is the length of ent0:=:river in ent0:=:state ?	add_node:-:B add_node:-:A add_edge:-:_len arg_node:-:B arg_node:-:A add_entity_node:-:ent0:=:river arg_node:-:B add_type_node:-:_river arg_node:-:B add_node:-:C add_edge:-:_loc arg_node:-:B arg_node:-:C add_entity_node:-:ent0:=:state arg_node:-:C return:-:A	ent0:=:river:::colorado:=:river ent0:=:state:::texas:=:state
what state has the highest population ?	add_operation:-:_largest add_node:-:A add_type_node:-:_state arg_node:-:A add_node:-:B add_edge:-:_population arg_node:-:A arg_node:-:B end_operation:-:arg ope_for:-:B return:-:A	
what is the state that contains the highest point ?	add_node:-:A add_type_node:-:_state arg_node:-:A add_node:-:B add_edge:-:_loc arg_node:-:B arg_node:-:A add_operation:-:_highest add_type_node:-:_place arg_node:-:B end_operation:-:arg ope_for:-:B return:-:A	
what is the population density of ent0:=:state ?	add_node:-:B add_node:-:A add_edge:-:_density arg_node:-:B arg_node:-:A add_entity_node:-:ent0:=:state arg_node:-:B return:-:A	ent0:=:state:::south_dakota:=:state
what states have cities named ent0:=:city ?	add_node:-:A add_type_node:-:_state arg_node:-:A add_node:-:B add_edge:-:_loc arg_node:-:B arg_node:-:A add_type_node:-:_city arg_node:-:B add_entity_node:-:ent0:=:city arg_node:-:B return:-:A	ent0:=:city:::austin:=:city
how many people live in ent0:=:state ?	add_node:-:B add_node:-:A add_edge:-:_population arg_node:-:B arg_node:-:A add_entity_node:-:ent0:=:state arg_node:-:B return:-:A	ent0:=:state:::montana:=:state
