what is the highest point in florida ?	add_operation:-:_highest add_node:-:A add_type_node:-:_place arg_node:-:A add_node:-:B add_edge:-:_loc arg_node:-:A arg_node:-:B add_entity_node:-:florida:=:state arg_node:-:B end_operation:-:arg ope_for:-:A return:-:A
what are the high point of state surround mississippi ?	add_node:-:B add_node:-:A add_edge:-:_high_point arg_node:-:B arg_node:-:A add_edge:-:_loc arg_node:-:A arg_node:-:B add_type_node:-:_state arg_node:-:B add_node:-:C add_edge:-:_next_to arg_node:-:B arg_node:-:C add_entity_node:-:mississippi:=:state arg_node:-:C return:-:A
what state has the shortest river ?	add_node:-:A add_type_node:-:_state arg_node:-:A add_node:-:B add_edge:-:_loc arg_node:-:B arg_node:-:A add_operation:-:_shortest add_type_node:-:_river arg_node:-:B end_operation:-:arg ope_for:-:B return:-:A
what is the tallest mountain in the united states ?	add_operation:-:_highest add_node:-:A add_type_node:-:_mountain arg_node:-:A add_node:-:B add_edge:-:_loc arg_node:-:A arg_node:-:B add_entity_node:-:usa:=:country arg_node:-:B end_operation:-:arg ope_for:-:A return:-:A
what is the capit of maine ?	add_node:-:A add_type_node:-:_capital arg_node:-:A add_node:-:B add_edge:-:_loc arg_node:-:A arg_node:-:B add_entity_node:-:maine:=:state arg_node:-:B return:-:A
what are the popul of state through which the mississippi river run ?	add_node:-:B add_node:-:A add_edge:-:_population arg_node:-:B arg_node:-:A add_type_node:-:_state arg_node:-:B add_node:-:C add_edge:-:_traverse arg_node:-:C arg_node:-:B add_entity_node:-:mississippi:=:river arg_node:-:C add_type_node:-:_river arg_node:-:C return:-:A
name all the lake of us ?	add_node:-:A add_type_node:-:_lake arg_node:-:A add_node:-:B add_edge:-:_loc arg_node:-:A arg_node:-:B add_entity_node:-:usa:=:country arg_node:-:B return:-:A
which state border state through which the mississippi traverses ?	add_node:-:A add_type_node:-:_state arg_node:-:A add_node:-:B add_edge:-:_next_to arg_node:-:A arg_node:-:B add_type_node:-:_state arg_node:-:B add_node:-:C add_edge:-:_traverse arg_node:-:C arg_node:-:B add_entity_node:-:mississippi:=:river arg_node:-:C return:-:A
what is the highest mountain in alaska ?	add_operation:-:_highest add_node:-:A add_type_node:-:_mountain arg_node:-:A add_node:-:B add_edge:-:_loc arg_node:-:A arg_node:-:B add_entity_node:-:alaska:=:state arg_node:-:B end_operation:-:arg ope_for:-:A return:-:A
what is the popul of illinois ?	add_node:-:B add_node:-:A add_edge:-:_population arg_node:-:B arg_node:-:A add_entity_node:-:illinois:=:state arg_node:-:B return:-:A
name all the river in colorado ?	add_node:-:A add_type_node:-:_river arg_node:-:A add_node:-:B add_edge:-:_loc arg_node:-:A arg_node:-:B add_entity_node:-:colorado:=:state arg_node:-:B return:-:A
in which state doe the highest point in usa exist ?	add_node:-:B add_node:-:A add_edge:-:_loc arg_node:-:B arg_node:-:A add_type_node:-:_state arg_node:-:A add_operation:-:_highest add_type_node:-:_place arg_node:-:B add_node:-:C add_edge:-:_loc arg_node:-:B arg_node:-:C add_entity_node:-:usa:=:country arg_node:-:C end_operation:-:arg ope_for:-:B return:-:A
which state is the city denver locat in ?	add_node:-:A add_type_node:-:_state arg_node:-:A add_node:-:B add_edge:-:_loc arg_node:-:B arg_node:-:A add_type_node:-:_city arg_node:-:B add_entity_node:-:denver:=:city arg_node:-:B return:-:A
what is the lowest point in texas ?	add_operation:-:_lowest add_node:-:A add_type_node:-:_place arg_node:-:A add_node:-:B add_edge:-:_loc arg_node:-:A arg_node:-:B add_entity_node:-:texas:=:state arg_node:-:B end_operation:-:arg ope_for:-:A return:-:A
how mani state have a citi call rochester ?	add_operation:-:_count add_node:-:B add_type_node:-:_state arg_node:-:B add_node:-:C add_edge:-:_loc arg_node:-:C arg_node:-:B add_entity_node:-:rochester:=:city arg_node:-:C end_operation:-:_count ope_for:-:B ope_return:-:A return:-:A
which capit are in the state that border texas ?	add_node:-:A add_type_node:-:_capital arg_node:-:A add_node:-:B add_edge:-:_loc arg_node:-:A arg_node:-:B add_type_node:-:_state arg_node:-:B add_node:-:C add_edge:-:_next_to arg_node:-:B arg_node:-:C add_entity_node:-:texas:=:state arg_node:-:C return:-:A
how mani peopl live in austin ?	add_node:-:B add_node:-:A add_edge:-:_population arg_node:-:B arg_node:-:A add_entity_node:-:austin:=:city arg_node:-:B return:-:A
what state have rivers named colorado ?	add_node:-:A add_type_node:-:_state arg_node:-:A add_node:-:B add_edge:-:_loc arg_node:-:B arg_node:-:A add_entity_node:-:colorado:=:river arg_node:-:B return:-:A
what is the size of texas ?	add_node:-:B add_node:-:A add_edge:-:_size arg_node:-:B arg_node:-:A add_entity_node:-:texas:=:state arg_node:-:B return:-:A
what is the shortest river in the usa ?	add_operation:-:_shortest add_node:-:A add_type_node:-:_river arg_node:-:A add_node:-:B add_edge:-:_loc arg_node:-:A arg_node:-:B add_entity_node:-:usa:=:country arg_node:-:B end_operation:-:arg ope_for:-:A return:-:A
what are the major citi of the us ?	add_node:-:A add_type_node:-:_major arg_node:-:A add_type_node:-:_city arg_node:-:A add_node:-:B add_edge:-:_loc arg_node:-:A arg_node:-:B add_entity_node:-:usa:=:country arg_node:-:B return:-:A
which state border kentucky ?	add_node:-:A add_type_node:-:_state arg_node:-:A add_node:-:B add_edge:-:_next_to arg_node:-:A arg_node:-:B add_entity_node:-:kentucky:=:state arg_node:-:B return:-:A
what is the popul of oregon ?	add_node:-:B add_node:-:A add_edge:-:_population arg_node:-:B arg_node:-:A add_entity_node:-:oregon:=:state arg_node:-:B return:-:A
what state have a citi name austin ?	add_node:-:A add_type_node:-:_state arg_node:-:A add_node:-:B add_edge:-:_loc arg_node:-:B arg_node:-:A add_entity_node:-:austin:=:city arg_node:-:B return:-:A
what is the highest elev in south carolina ?	add_operation:-:_highest add_node:-:A add_type_node:-:_place arg_node:-:A add_node:-:B add_edge:-:_loc arg_node:-:A arg_node:-:B add_entity_node:-:south_carolina:=:state arg_node:-:B end_operation:-:arg ope_for:-:A return:-:A
how mani peopl live in austin texas ?	add_node:-:B add_node:-:A add_edge:-:_population arg_node:-:B arg_node:-:A add_entity_node:-:austin_tx:=:city arg_node:-:B return:-:A
what are the river in the state of texas ?	add_node:-:A add_type_node:-:_river arg_node:-:A add_node:-:B add_edge:-:_loc arg_node:-:A arg_node:-:B add_type_node:-:_state arg_node:-:B add_entity_node:-:texas:=:state arg_node:-:B return:-:A
what is the lowest point of colorado ?	add_operation:-:_lowest add_node:-:A add_type_node:-:_place arg_node:-:A add_node:-:B add_edge:-:_loc arg_node:-:A arg_node:-:B add_entity_node:-:colorado:=:state arg_node:-:B end_operation:-:arg ope_for:-:A return:-:A
what is the popul of atlanta ?	add_node:-:B add_node:-:A add_edge:-:_population arg_node:-:B arg_node:-:A add_entity_node:-:atlanta:=:city arg_node:-:B return:-:A
what river are in utah ?	add_node:-:A add_type_node:-:_river arg_node:-:A add_node:-:B add_edge:-:_loc arg_node:-:A arg_node:-:B add_entity_node:-:utah:=:state arg_node:-:B return:-:A
what river run through the most state ?	add_operation:-:_most add_node:-:A add_type_node:-:_river arg_node:-:A add_node:-:B add_edge:-:_traverse arg_node:-:A arg_node:-:B add_type_node:-:_state arg_node:-:B end_operation:-:arg_count ope_for:-:A ope_for:-:B return:-:A
what is the population of sacramento ?	add_node:-:B add_node:-:A add_edge:-:_population arg_node:-:B arg_node:-:A add_entity_node:-:sacramento:=:city arg_node:-:B return:-:A
could you tell me what is the highest point in the state of oregon ?	add_operation:-:_highest add_node:-:A add_type_node:-:_place arg_node:-:A add_node:-:B add_edge:-:_loc arg_node:-:A arg_node:-:B add_type_node:-:_state arg_node:-:B add_entity_node:-:oregon:=:state arg_node:-:B end_operation:-:arg ope_for:-:A return:-:A
which state doe the mississippi river run through ?	add_node:-:A add_type_node:-:_state arg_node:-:A add_node:-:B add_edge:-:_traverse arg_node:-:B arg_node:-:A add_entity_node:-:mississippi:=:river arg_node:-:B add_type_node:-:_river arg_node:-:B return:-:A
what are the major citi in the smallest state in the us ?	add_node:-:A add_type_node:-:_major arg_node:-:A add_type_node:-:_city arg_node:-:A add_node:-:B add_edge:-:_loc arg_node:-:A arg_node:-:B add_operation:-:_smallest add_type_node:-:_state arg_node:-:B add_node:-:C add_edge:-:_loc arg_node:-:B arg_node:-:C add_entity_node:-:usa:=:country arg_node:-:C end_operation:-:arg ope_for:-:B return:-:A
how high is guadalupe peak ?	add_node:-:B add_node:-:A add_edge:-:_elevation arg_node:-:B arg_node:-:A add_entity_node:-:guadalupe_peak:=:place arg_node:-:B return:-:A
what river run through illinois ?	add_node:-:A add_type_node:-:_river arg_node:-:A add_node:-:B add_edge:-:_traverse arg_node:-:A arg_node:-:B add_entity_node:-:illinois:=:state arg_node:-:B return:-:A
how long is the mississippi river ?	add_node:-:B add_node:-:A add_edge:-:_len arg_node:-:B arg_node:-:A add_entity_node:-:mississippi:=:river arg_node:-:B add_type_node:-:_river arg_node:-:B return:-:A
how high is the highest point in the largest state ?	add_node:-:B add_node:-:A add_edge:-:_elevation arg_node:-:B arg_node:-:A add_operation:-:_highest add_type_node:-:_place arg_node:-:B add_node:-:C add_edge:-:_loc arg_node:-:B arg_node:-:C add_operation:-:_largest add_type_node:-:_state arg_node:-:C end_operation:-:arg ope_for:-:C end_operation:-:arg ope_for:-:B return:-:A
what is the area of south carolina ?	add_node:-:B add_node:-:A add_edge:-:_area arg_node:-:B arg_node:-:A add_entity_node:-:south_carolina:=:state arg_node:-:B return:-:A
what are the state through which the longest river run ?	add_node:-:A add_type_node:-:_state arg_node:-:A add_operation:-:_longest add_node:-:B add_edge:-:_traverse arg_node:-:B arg_node:-:A add_type_node:-:_river arg_node:-:B end_operation:-:arg ope_for:-:B return:-:A
where is new orleans ?	add_node:-:B add_node:-:A add_edge:-:_loc arg_node:-:B arg_node:-:A add_entity_node:-:new_orleans:=:city arg_node:-:B return:-:A
in what state is mount mckinley ?	add_node:-:B add_node:-:A add_edge:-:_loc arg_node:-:B arg_node:-:A add_type_node:-:_state arg_node:-:A add_entity_node:-:mount_mckinley:=:place arg_node:-:B return:-:A
what state has highest elev ?	add_node:-:A add_type_node:-:_state arg_node:-:A add_node:-:B add_edge:-:_loc arg_node:-:B arg_node:-:A add_operation:-:_highest add_type_node:-:_place arg_node:-:B end_operation:-:arg ope_for:-:B return:-:A
what is the size of california ?	add_node:-:B add_node:-:A add_edge:-:_size arg_node:-:B arg_node:-:A add_entity_node:-:california:=:state arg_node:-:B return:-:A
what is the smallest state that border texas ?	add_operation:-:_smallest add_node:-:A add_type_node:-:_state arg_node:-:A add_node:-:B add_edge:-:_next_to arg_node:-:A arg_node:-:B add_entity_node:-:texas:=:state arg_node:-:B end_operation:-:arg ope_for:-:A return:-:A
how mani citizen in alabama ?	add_node:-:B add_node:-:A add_edge:-:_population arg_node:-:B arg_node:-:A add_entity_node:-:alabama:=:state arg_node:-:B return:-:A
in which state is rochester ?	add_node:-:B add_node:-:A add_edge:-:_loc arg_node:-:B arg_node:-:A add_type_node:-:_state arg_node:-:A add_entity_node:-:rochester:=:city arg_node:-:B return:-:A
how mani state in the us doe the shortest river run through ?	add_operation:-:_count add_node:-:B add_type_node:-:_state arg_node:-:B add_node:-:C add_edge:-:_loc arg_node:-:B arg_node:-:C add_entity_node:-:usa:=:country arg_node:-:C add_node:-:D add_edge:-:_traverse arg_node:-:D arg_node:-:B add_operation:-:_shortest add_type_node:-:_river arg_node:-:D end_operation:-:arg ope_for:-:D end_operation:-:_count ope_for:-:B ope_return:-:A return:-:A
what is the biggest state in continental us ?	add_operation:-:_largest add_node:-:A add_type_node:-:_state arg_node:-:A add_node:-:B add_edge:-:_loc arg_node:-:A arg_node:-:B add_entity_node:-:usa:=:country arg_node:-:B end_operation:-:arg ope_for:-:A return:-:A
what is the area of the largest state ?	add_node:-:B add_node:-:A add_edge:-:_area arg_node:-:B arg_node:-:A add_operation:-:_largest add_type_node:-:_state arg_node:-:B end_operation:-:arg ope_for:-:B return:-:A
where is mount whitney ?	add_node:-:B add_node:-:A add_edge:-:_loc arg_node:-:B arg_node:-:A add_entity_node:-:mount_whitney:=:place arg_node:-:B return:-:A
how mani state doe iowa border ?	add_operation:-:_count add_node:-:B add_type_node:-:_state arg_node:-:B add_node:-:C add_edge:-:_next_to arg_node:-:C arg_node:-:B add_entity_node:-:iowa:=:state arg_node:-:C end_operation:-:_count ope_for:-:B ope_return:-:A return:-:A
which state doe the longest river cross ?	add_node:-:A add_type_node:-:_state arg_node:-:A add_node:-:B add_edge:-:_traverse arg_node:-:B arg_node:-:A add_operation:-:_longest add_type_node:-:_river arg_node:-:B end_operation:-:arg ope_for:-:B return:-:A
what river flow through kansas ?	add_node:-:A add_type_node:-:_river arg_node:-:A add_node:-:B add_edge:-:_traverse arg_node:-:A arg_node:-:B add_entity_node:-:kansas:=:state arg_node:-:B return:-:A
what is the popul of austin texas ?	add_node:-:B add_node:-:A add_edge:-:_population arg_node:-:B arg_node:-:A add_entity_node:-:austin_tx:=:city arg_node:-:B return:-:A
what is the capit of vermont ?	add_node:-:A add_type_node:-:_capital arg_node:-:A add_node:-:B add_edge:-:_loc arg_node:-:A arg_node:-:B add_entity_node:-:vermont:=:state arg_node:-:B return:-:A
which state border colorado ?	add_node:-:A add_type_node:-:_state arg_node:-:A add_node:-:B add_edge:-:_next_to arg_node:-:A arg_node:-:B add_entity_node:-:colorado:=:state arg_node:-:B return:-:A
how long is the mississippi ?	add_node:-:B add_node:-:A add_edge:-:_len arg_node:-:B arg_node:-:A add_entity_node:-:mississippi:=:river arg_node:-:B return:-:A
what state has the largest popul densiti ?	add_operation:-:_largest add_node:-:A add_type_node:-:_state arg_node:-:A add_node:-:B add_edge:-:_density arg_node:-:A arg_node:-:B end_operation:-:arg ope_for:-:B return:-:A
what state border georgia ?	add_node:-:A add_type_node:-:_state arg_node:-:A add_node:-:B add_edge:-:_next_to arg_node:-:A arg_node:-:B add_entity_node:-:georgia:=:state arg_node:-:B return:-:A
what is the capit of pennsylvania ?	add_node:-:A add_type_node:-:_capital arg_node:-:A add_node:-:B add_edge:-:_loc arg_node:-:A arg_node:-:B add_entity_node:-:pennsylvania:=:state arg_node:-:B return:-:A
what are the biggest river in texas ?	add_operation:-:_longest add_node:-:A add_type_node:-:_river arg_node:-:A add_node:-:B add_edge:-:_loc arg_node:-:A arg_node:-:B add_entity_node:-:texas:=:state arg_node:-:B end_operation:-:arg ope_for:-:A return:-:A
what is the longest river in the united states ?	add_operation:-:_longest add_node:-:A add_type_node:-:_river arg_node:-:A add_node:-:B add_edge:-:_loc arg_node:-:A arg_node:-:B add_entity_node:-:usa:=:country arg_node:-:B end_operation:-:arg ope_for:-:A return:-:A
what is the capit of utah ?	add_node:-:A add_type_node:-:_capital arg_node:-:A add_node:-:B add_edge:-:_loc arg_node:-:A arg_node:-:B add_entity_node:-:utah:=:state arg_node:-:B return:-:A
what state has the smallest popul densiti ?	add_operation:-:_smallest add_node:-:A add_type_node:-:_state arg_node:-:A add_node:-:B add_edge:-:_density arg_node:-:A arg_node:-:B end_operation:-:arg ope_for:-:B return:-:A
which capit are not major citi ?	add_node:-:A add_type_node:-:_capital arg_node:-:A add_operation:-:_not add_type_node:-:_major arg_node:-:A add_type_node:-:_city arg_node:-:A end_operation:-:_not return:-:A
what is the biggest citi in nebraska ?	add_operation:-:_largest add_node:-:A add_type_node:-:_city arg_node:-:A add_node:-:B add_edge:-:_loc arg_node:-:A arg_node:-:B add_entity_node:-:nebraska:=:state arg_node:-:B end_operation:-:arg ope_for:-:A return:-:A
what is the popul of texas ?	add_node:-:B add_node:-:A add_edge:-:_population arg_node:-:B arg_node:-:A add_entity_node:-:texas:=:state arg_node:-:B return:-:A
what is the shortest river in the united states ?	add_operation:-:_shortest add_node:-:A add_type_node:-:_river arg_node:-:A add_node:-:B add_edge:-:_loc arg_node:-:A arg_node:-:B add_entity_node:-:usa:=:country arg_node:-:B end_operation:-:arg ope_for:-:A return:-:A
what is the popul of rhode island ?	add_node:-:B add_node:-:A add_edge:-:_population arg_node:-:B arg_node:-:A add_entity_node:-:rhode_island:=:state arg_node:-:B return:-:A
what is the state with the lowest point ?	add_node:-:A add_type_node:-:_state arg_node:-:A add_node:-:B add_edge:-:_loc arg_node:-:B arg_node:-:A add_operation:-:_lowest add_type_node:-:_place arg_node:-:B end_operation:-:arg ope_for:-:B return:-:A
what is the longest river in new york ?	add_operation:-:_longest add_node:-:A add_type_node:-:_river arg_node:-:A add_node:-:B add_edge:-:_loc arg_node:-:A arg_node:-:B add_entity_node:-:new_york:=:state arg_node:-:B end_operation:-:arg ope_for:-:A return:-:A
what is the longest river that run through a state that border tennessee ?	add_operation:-:_longest add_node:-:A add_type_node:-:_river arg_node:-:A add_node:-:B add_edge:-:_traverse arg_node:-:A arg_node:-:B add_type_node:-:_state arg_node:-:B add_node:-:C add_edge:-:_next_to arg_node:-:B arg_node:-:C add_entity_node:-:tennessee:=:state arg_node:-:C end_operation:-:arg ope_for:-:A return:-:A
how mani major citi are in arizona ?	add_operation:-:_count add_node:-:B add_type_node:-:_major arg_node:-:B add_type_node:-:_city arg_node:-:B add_node:-:C add_edge:-:_loc arg_node:-:B arg_node:-:C add_entity_node:-:arizona:=:state arg_node:-:C end_operation:-:_count ope_for:-:B ope_return:-:A return:-:A
what are the neighbor state for michigan ?	add_node:-:A add_node:-:B add_edge:-:_next_to arg_node:-:A arg_node:-:B add_type_node:-:_state arg_node:-:A add_entity_node:-:michigan:=:state arg_node:-:B return:-:A
what state that border texas is the largest ?	add_operation:-:_largest add_node:-:A add_type_node:-:_state arg_node:-:A add_node:-:B add_edge:-:_next_to arg_node:-:A arg_node:-:B add_entity_node:-:texas:=:state arg_node:-:B end_operation:-:arg ope_for:-:A return:-:A
what is the shortest river ?	add_operation:-:_shortest add_node:-:A add_type_node:-:_river arg_node:-:A end_operation:-:arg ope_for:-:A return:-:A
how mani state border the state that border the most state ?	add_operation:-:_count add_node:-:B add_type_node:-:_state arg_node:-:B add_node:-:C add_edge:-:_next_to arg_node:-:B arg_node:-:C add_operation:-:_most add_type_node:-:_state arg_node:-:C add_node:-:D add_edge:-:_next_to arg_node:-:C arg_node:-:D add_type_node:-:_state arg_node:-:D end_operation:-:arg_count ope_for:-:C ope_for:-:D end_operation:-:_count ope_for:-:B ope_return:-:A return:-:A
which state is the largest citi in montana in ?	add_node:-:A add_type_node:-:_state arg_node:-:A add_node:-:B add_edge:-:_loc arg_node:-:B arg_node:-:A add_operation:-:_largest add_type_node:-:_city arg_node:-:B add_node:-:C add_edge:-:_loc arg_node:-:B arg_node:-:C add_entity_node:-:montana:=:state arg_node:-:C end_operation:-:arg ope_for:-:B return:-:A
what is the popul of washington dc ?	add_node:-:B add_node:-:A add_edge:-:_population arg_node:-:B arg_node:-:A add_entity_node:-:washington_dc:=:city arg_node:-:B return:-:A
what is the most popul citi in texas ?	add_operation:-:_largest add_node:-:B add_node:-:A add_edge:-:_population arg_node:-:B arg_node:-:A add_type_node:-:_city arg_node:-:B add_node:-:C add_edge:-:_loc arg_node:-:B arg_node:-:C add_entity_node:-:texas:=:state arg_node:-:C end_operation:-:arg ope_for:-:A return:-:B
what is the capit of hawaii ?	add_node:-:A add_type_node:-:_capital arg_node:-:A add_node:-:B add_edge:-:_loc arg_node:-:A arg_node:-:B add_entity_node:-:hawaii:=:state arg_node:-:B return:-:A
what is capit of iowa ?	add_node:-:A add_type_node:-:_capital arg_node:-:A add_node:-:B add_edge:-:_loc arg_node:-:A arg_node:-:B add_entity_node:-:iowa:=:state arg_node:-:B return:-:A
where is san diego ?	add_node:-:B add_node:-:A add_edge:-:_loc arg_node:-:B arg_node:-:A add_entity_node:-:san_diego:=:city arg_node:-:B return:-:A
what are the major citi in delaware ?	add_node:-:A add_type_node:-:_major arg_node:-:A add_type_node:-:_city arg_node:-:A add_node:-:B add_edge:-:_loc arg_node:-:A arg_node:-:B add_entity_node:-:delaware:=:state arg_node:-:B return:-:A
what is the lowest point in louisiana ?	add_operation:-:_lowest add_node:-:A add_type_node:-:_place arg_node:-:A add_node:-:B add_edge:-:_loc arg_node:-:A arg_node:-:B add_entity_node:-:louisiana:=:state arg_node:-:B end_operation:-:arg ope_for:-:A return:-:A
which state has the highest peak in the country ?	add_operation:-:_highest add_node:-:A add_type_node:-:_state arg_node:-:A add_node:-:B add_edge:-:_loc arg_node:-:B arg_node:-:A add_type_node:-:_mountain arg_node:-:B end_operation:-:arg ope_for:-:B return:-:A
what texas citi has the largest popul ?	add_operation:-:_largest add_node:-:C add_entity_node:-:texas:=:state arg_node:-:C add_node:-:A add_edge:-:_loc arg_node:-:A arg_node:-:C add_node:-:B add_edge:-:_population arg_node:-:A arg_node:-:B add_type_node:-:_city arg_node:-:A end_operation:-:arg ope_for:-:B return:-:A
what capit is the largest in the us ?	add_operation:-:_largest add_node:-:A add_type_node:-:_capital arg_node:-:A add_node:-:B add_edge:-:_loc arg_node:-:A arg_node:-:B add_entity_node:-:usa:=:country arg_node:-:B end_operation:-:arg ope_for:-:A return:-:A
what is the popul of new york ?	add_node:-:B add_node:-:A add_edge:-:_population arg_node:-:B arg_node:-:A add_entity_node:-:new_york:=:state arg_node:-:B return:-:A
what is the popul of the capit of the smallest state ?	add_node:-:B add_node:-:A add_edge:-:_population arg_node:-:B arg_node:-:A add_type_node:-:_capital arg_node:-:B add_node:-:C add_edge:-:_loc arg_node:-:B arg_node:-:C add_operation:-:_smallest add_type_node:-:_state arg_node:-:C end_operation:-:arg ope_for:-:C return:-:A
what is the area of alaska ?	add_node:-:B add_node:-:A add_edge:-:_area arg_node:-:B arg_node:-:A add_entity_node:-:alaska:=:state arg_node:-:B return:-:A
what is the popul of california ?	add_node:-:B add_node:-:A add_edge:-:_population arg_node:-:B arg_node:-:A add_entity_node:-:california:=:state arg_node:-:B return:-:A
which state has the longest river ?	add_operation:-:_longest add_node:-:A add_type_node:-:_state arg_node:-:A add_node:-:B add_edge:-:_loc arg_node:-:B arg_node:-:A add_type_node:-:_river arg_node:-:B end_operation:-:arg ope_for:-:B return:-:A
what is the capit of texas ?	add_node:-:A add_type_node:-:_capital arg_node:-:A add_node:-:B add_edge:-:_loc arg_node:-:A arg_node:-:B add_entity_node:-:texas:=:state arg_node:-:B return:-:A
give me the citi which are in texas ?	add_node:-:A add_type_node:-:_city arg_node:-:A add_node:-:B add_edge:-:_loc arg_node:-:A arg_node:-:B add_entity_node:-:texas:=:state arg_node:-:B return:-:A
what state border kentucky ?	add_node:-:A add_type_node:-:_state arg_node:-:A add_node:-:B add_edge:-:_next_to arg_node:-:A arg_node:-:B add_entity_node:-:kentucky:=:state arg_node:-:B return:-:A
how high is the highest point of florida ?	add_node:-:B add_node:-:A add_edge:-:_elevation arg_node:-:B arg_node:-:A add_operation:-:_highest add_type_node:-:_place arg_node:-:B add_node:-:C add_edge:-:_loc arg_node:-:B arg_node:-:C add_entity_node:-:florida:=:state arg_node:-:C end_operation:-:arg ope_for:-:B return:-:A
what are the major citi in north carolina ?	add_node:-:A add_type_node:-:_major arg_node:-:A add_type_node:-:_city arg_node:-:A add_node:-:B add_edge:-:_loc arg_node:-:A arg_node:-:B add_entity_node:-:north_carolina:=:state arg_node:-:B return:-:A
what is the highest point in the state with capit des moines ?	add_operation:-:_highest add_node:-:A add_type_node:-:_place arg_node:-:A add_node:-:B add_edge:-:_loc arg_node:-:A arg_node:-:B add_type_node:-:_state arg_node:-:B add_node:-:C add_edge:-:_loc arg_node:-:C arg_node:-:B add_type_node:-:_capital arg_node:-:C add_entity_node:-:des_moines:=:city arg_node:-:C end_operation:-:arg ope_for:-:A return:-:A
what is the lowest point in california ?	add_operation:-:_lowest add_node:-:A add_type_node:-:_place arg_node:-:A add_node:-:B add_edge:-:_loc arg_node:-:A arg_node:-:B add_entity_node:-:california:=:state arg_node:-:B end_operation:-:arg ope_for:-:A return:-:A
what is the biggest citi in wyoming ?	add_operation:-:_largest add_node:-:A add_type_node:-:_city arg_node:-:A add_node:-:B add_edge:-:_loc arg_node:-:A arg_node:-:B add_entity_node:-:wyoming:=:state arg_node:-:B end_operation:-:arg ope_for:-:A return:-:A
what is the largest state border texas ?	add_operation:-:_largest add_node:-:A add_type_node:-:_state arg_node:-:A add_node:-:B add_edge:-:_next_to arg_node:-:A arg_node:-:B add_entity_node:-:texas:=:state arg_node:-:B end_operation:-:arg ope_for:-:A return:-:A
what is the smallest citi in hawaii ?	add_operation:-:_smallest add_node:-:A add_type_node:-:_city arg_node:-:A add_node:-:B add_edge:-:_loc arg_node:-:A arg_node:-:B add_entity_node:-:hawaii:=:state arg_node:-:B end_operation:-:arg ope_for:-:A return:-:A
what is the area of the state ?	add_node:-:B add_node:-:A add_edge:-:_area arg_node:-:B arg_node:-:A add_type_node:-:_state arg_node:-:B return:-:A
what is the area of idaho ?	add_node:-:B add_node:-:A add_edge:-:_area arg_node:-:B arg_node:-:A add_entity_node:-:idaho:=:state arg_node:-:B return:-:A
what state has the most river run through it ?	add_operation:-:_most add_node:-:A add_type_node:-:_state arg_node:-:A add_node:-:B add_edge:-:_loc arg_node:-:B arg_node:-:A add_type_node:-:_river arg_node:-:B add_edge:-:_traverse arg_node:-:B arg_node:-:A end_operation:-:arg_count ope_for:-:A ope_for:-:B return:-:A
what is the popul of springfield missouri ?	add_node:-:B add_node:-:A add_edge:-:_population arg_node:-:B arg_node:-:A add_entity_node:-:springfield_mo:=:city arg_node:-:B return:-:A
what is the most popul state border oklahoma ?	add_operation:-:_largest add_node:-:A add_node:-:B add_edge:-:_population arg_node:-:A arg_node:-:B add_type_node:-:_state arg_node:-:A add_node:-:C add_edge:-:_next_to arg_node:-:A arg_node:-:C add_entity_node:-:oklahoma:=:state arg_node:-:C end_operation:-:arg ope_for:-:B return:-:A
what is the number of neighbor state for kentucky ?	add_operation:-:_count add_node:-:B add_type_node:-:_state arg_node:-:B add_node:-:C add_edge:-:_next_to arg_node:-:B arg_node:-:C add_entity_node:-:kentucky:=:state arg_node:-:C end_operation:-:_count ope_for:-:B ope_return:-:A return:-:A
what is the averag popul per squar km in pennsylvania ?	add_node:-:B add_node:-:A add_edge:-:_density arg_node:-:B arg_node:-:A add_entity_node:-:pennsylvania:=:state arg_node:-:B return:-:A
what state has the highest popul densiti ?	add_operation:-:_largest add_node:-:A add_type_node:-:_state arg_node:-:A add_node:-:B add_edge:-:_density arg_node:-:A arg_node:-:B end_operation:-:arg ope_for:-:B return:-:A
what is the tallest mountain in america ?	add_operation:-:_highest add_node:-:A add_type_node:-:_mountain arg_node:-:A add_node:-:B add_edge:-:_loc arg_node:-:A arg_node:-:B add_entity_node:-:usa:=:country arg_node:-:B end_operation:-:arg ope_for:-:A return:-:A
what is the highest point of the state with the largest area ?	add_operation:-:_highest add_node:-:A add_type_node:-:_place arg_node:-:A add_node:-:B add_edge:-:_loc arg_node:-:A arg_node:-:B add_operation:-:_largest add_type_node:-:_state arg_node:-:B add_node:-:C add_edge:-:_area arg_node:-:B arg_node:-:C end_operation:-:arg ope_for:-:C end_operation:-:arg ope_for:-:A return:-:A
what are the state ?	add_node:-:A add_type_node:-:_state arg_node:-:A return:-:A
how mani river in washington ?	add_operation:-:_count add_node:-:B add_type_node:-:_river arg_node:-:B add_node:-:C add_edge:-:_loc arg_node:-:B arg_node:-:C add_entity_node:-:washington:=:state arg_node:-:C end_operation:-:_count ope_for:-:B ope_return:-:A return:-:A
what are the popul of the state through which the mississippi river run ?	add_node:-:B add_node:-:A add_edge:-:_population arg_node:-:B arg_node:-:A add_type_node:-:_state arg_node:-:B add_node:-:C add_edge:-:_traverse arg_node:-:C arg_node:-:B add_entity_node:-:mississippi:=:river arg_node:-:C add_type_node:-:_river arg_node:-:C return:-:A
what is the biggest river in illinois ?	add_operation:-:_largest add_node:-:A add_type_node:-:_river arg_node:-:A add_node:-:B add_edge:-:_loc arg_node:-:A arg_node:-:B add_entity_node:-:illinois:=:state arg_node:-:B end_operation:-:arg ope_for:-:A return:-:A
what is the capit of michigan ?	add_node:-:A add_type_node:-:_capital arg_node:-:A add_node:-:B add_edge:-:_loc arg_node:-:A arg_node:-:B add_entity_node:-:michigan:=:state arg_node:-:B return:-:A
what is the total popul of the state that border texas ?	add_operation:-:_sum add_node:-:C add_type_node:-:_state arg_node:-:C add_node:-:D add_edge:-:_next_to arg_node:-:D arg_node:-:C add_entity_node:-:texas:=:state arg_node:-:D add_type_node:-:_population arg_node:-:C end_operation:-:_sum ope_for:-:C ope_in:-:_population ope_return:-:A return:-:A
what state border rhode island ?	add_node:-:A add_type_node:-:_state arg_node:-:A add_node:-:B add_edge:-:_next_to arg_node:-:A arg_node:-:B add_entity_node:-:rhode_island:=:state arg_node:-:B return:-:A
what is the biggest citi in oregon ?	add_operation:-:_largest add_node:-:A add_type_node:-:_city arg_node:-:A add_node:-:B add_edge:-:_loc arg_node:-:A arg_node:-:B add_entity_node:-:oregon:=:state arg_node:-:B end_operation:-:arg ope_for:-:A return:-:A
what is the lowest point in wisconsin ?	add_operation:-:_lowest add_node:-:A add_type_node:-:_place arg_node:-:A add_node:-:B add_edge:-:_loc arg_node:-:A arg_node:-:B add_entity_node:-:wisconsin:=:state arg_node:-:B end_operation:-:arg ope_for:-:A return:-:A
what are the river in the state of indiana ?	add_node:-:A add_type_node:-:_river arg_node:-:A add_node:-:B add_edge:-:_loc arg_node:-:A arg_node:-:B add_type_node:-:_state arg_node:-:B add_entity_node:-:indiana:=:state arg_node:-:B return:-:A
what is the popul of austin ?	add_node:-:B add_node:-:A add_edge:-:_population arg_node:-:B arg_node:-:A add_entity_node:-:austin:=:city arg_node:-:B return:-:A
what is the smallest citi in arkansas ?	add_operation:-:_smallest add_node:-:A add_type_node:-:_city arg_node:-:A add_node:-:B add_edge:-:_loc arg_node:-:A arg_node:-:B add_entity_node:-:arkansas:=:state arg_node:-:B end_operation:-:arg ope_for:-:A return:-:A
give me the longest river that pass through the us ?	add_operation:-:_longest add_node:-:A add_type_node:-:_river arg_node:-:A add_node:-:B add_edge:-:_traverse arg_node:-:A arg_node:-:B add_entity_node:-:usa:=:country arg_node:-:B end_operation:-:arg ope_for:-:A return:-:A
how long is the missouri river ?	add_node:-:B add_node:-:A add_edge:-:_len arg_node:-:B arg_node:-:A add_entity_node:-:missouri:=:river arg_node:-:B add_type_node:-:_river arg_node:-:B return:-:A
which state has the largest citi ?	add_operation:-:_largest add_node:-:A add_type_node:-:_state arg_node:-:A add_node:-:B add_edge:-:_loc arg_node:-:B arg_node:-:A add_type_node:-:_city arg_node:-:B end_operation:-:arg ope_for:-:B return:-:A
what is the lowest elev in pennsylvania ?	add_operation:-:_lowest add_node:-:A add_type_node:-:_place arg_node:-:A add_node:-:B add_edge:-:_loc arg_node:-:A arg_node:-:B add_entity_node:-:pennsylvania:=:state arg_node:-:B end_operation:-:arg ope_for:-:A return:-:A
what is the longest river in the state with the highest point ?	add_operation:-:_longest add_node:-:A add_type_node:-:_river arg_node:-:A add_node:-:B add_edge:-:_loc arg_node:-:A arg_node:-:B add_type_node:-:_state arg_node:-:B add_node:-:C add_edge:-:_loc arg_node:-:C arg_node:-:B add_operation:-:_highest add_type_node:-:_place arg_node:-:C end_operation:-:arg ope_for:-:C end_operation:-:arg ope_for:-:A return:-:A
what state doe the colorado river run through ?	add_node:-:A add_type_node:-:_state arg_node:-:A add_node:-:B add_edge:-:_traverse arg_node:-:B arg_node:-:A add_entity_node:-:colorado:=:river arg_node:-:B add_type_node:-:_river arg_node:-:B return:-:A
what are the state that the potomac run through ?	add_node:-:A add_type_node:-:_state arg_node:-:A add_node:-:B add_edge:-:_traverse arg_node:-:B arg_node:-:A add_entity_node:-:potomac:=:river arg_node:-:B return:-:A
what is the biggest citi in the usa ?	add_operation:-:_largest add_node:-:A add_type_node:-:_city arg_node:-:A add_node:-:B add_edge:-:_loc arg_node:-:A arg_node:-:B add_entity_node:-:usa:=:country arg_node:-:B end_operation:-:arg ope_for:-:A return:-:A
what state has no river ?	add_node:-:A add_type_node:-:_state arg_node:-:A add_operation:-:_not add_node:-:B add_edge:-:_loc arg_node:-:B arg_node:-:A add_type_node:-:_river arg_node:-:B end_operation:-:_not return:-:A
what is the highest point in rhode island ?	add_operation:-:_highest add_node:-:A add_type_node:-:_place arg_node:-:A add_node:-:B add_edge:-:_loc arg_node:-:A arg_node:-:B add_entity_node:-:rhode_island:=:state arg_node:-:B end_operation:-:arg ope_for:-:A return:-:A
name the state which have no surround state ?	add_node:-:A add_type_node:-:_state arg_node:-:A add_operation:-:_not add_node:-:B add_edge:-:_next_to arg_node:-:A arg_node:-:B add_type_node:-:_state arg_node:-:B end_operation:-:_not return:-:A
what is the popul of atlanta ga ?	add_node:-:B add_node:-:A add_edge:-:_population arg_node:-:B arg_node:-:A add_entity_node:-:atlanta:=:city arg_node:-:B return:-:A
how mani squar kilomet in the us ?	add_node:-:B add_node:-:A add_edge:-:_area arg_node:-:B arg_node:-:A add_entity_node:-:usa:=:country arg_node:-:B return:-:A
what is the popul of idaho ?	add_node:-:B add_node:-:A add_edge:-:_population arg_node:-:B arg_node:-:A add_entity_node:-:idaho:=:state arg_node:-:B return:-:A
what is the adjac state of california ?	add_node:-:A add_node:-:B add_edge:-:_next_to arg_node:-:A arg_node:-:B add_type_node:-:_state arg_node:-:A add_entity_node:-:california:=:state arg_node:-:B return:-:A
what is the smallest state through which the longest river run ?	add_operation:-:_smallest add_node:-:A add_type_node:-:_state arg_node:-:A add_node:-:B add_edge:-:_traverse arg_node:-:B arg_node:-:A add_operation:-:_longest add_type_node:-:_river arg_node:-:B end_operation:-:arg ope_for:-:B end_operation:-:arg ope_for:-:A return:-:A
what are the name of the major citi in illinois ?	add_node:-:A add_type_node:-:_major arg_node:-:A add_type_node:-:_city arg_node:-:A add_node:-:B add_edge:-:_loc arg_node:-:A arg_node:-:B add_entity_node:-:illinois:=:state arg_node:-:B return:-:A
how mani state doe the colorado river run through ?	add_operation:-:_count add_node:-:B add_type_node:-:_state arg_node:-:B add_node:-:C add_edge:-:_traverse arg_node:-:C arg_node:-:B add_entity_node:-:colorado:=:river arg_node:-:C add_type_node:-:_river arg_node:-:C end_operation:-:_count ope_for:-:B ope_return:-:A return:-:A
how mani state doe the colorado river flow through ?	add_operation:-:_count add_node:-:B add_type_node:-:_state arg_node:-:B add_node:-:C add_edge:-:_traverse arg_node:-:C arg_node:-:B add_entity_node:-:colorado:=:river arg_node:-:C add_type_node:-:_river arg_node:-:C end_operation:-:_count ope_for:-:B ope_return:-:A return:-:A
what are the major citi in kansas ?	add_node:-:A add_type_node:-:_major arg_node:-:A add_type_node:-:_city arg_node:-:A add_node:-:B add_edge:-:_loc arg_node:-:A arg_node:-:B add_entity_node:-:kansas:=:state arg_node:-:B return:-:A
which state border texas ?	add_node:-:A add_type_node:-:_state arg_node:-:A add_node:-:B add_edge:-:_next_to arg_node:-:A arg_node:-:B add_entity_node:-:texas:=:state arg_node:-:B return:-:A
how mani peopl live in new york ?	add_node:-:B add_node:-:A add_edge:-:_population arg_node:-:B arg_node:-:A add_entity_node:-:new_york:=:state arg_node:-:B return:-:A
what are the largest citi in the state that border the largest state ?	add_operation:-:_largest add_node:-:A add_type_node:-:_city arg_node:-:A add_node:-:B add_edge:-:_loc arg_node:-:A arg_node:-:B add_type_node:-:_state arg_node:-:B add_node:-:C add_edge:-:_next_to arg_node:-:B arg_node:-:C add_operation:-:_largest add_type_node:-:_state arg_node:-:C end_operation:-:arg ope_for:-:C end_operation:-:arg ope_for:-:A return:-:A
which state have point that are higher than the highest point in texas ?	add_node:-:A add_type_node:-:_state arg_node:-:A add_node:-:B add_edge:-:_loc arg_node:-:B arg_node:-:A add_node:-:C add_edge:-:_higher arg_node:-:B arg_node:-:C add_operation:-:_highest add_type_node:-:_place arg_node:-:C add_node:-:D add_edge:-:_loc arg_node:-:C arg_node:-:D add_entity_node:-:texas:=:state arg_node:-:D end_operation:-:arg ope_for:-:C add_type_node:-:_place arg_node:-:B return:-:A
what is the river that cross over ohio ?	add_node:-:A add_type_node:-:_river arg_node:-:A add_node:-:B add_edge:-:_traverse arg_node:-:A arg_node:-:B add_entity_node:-:ohio:=:state arg_node:-:B return:-:A
what is the largest citi in michigan ?	add_operation:-:_largest add_node:-:A add_type_node:-:_city arg_node:-:A add_node:-:B add_edge:-:_loc arg_node:-:A arg_node:-:B add_entity_node:-:michigan:=:state arg_node:-:B end_operation:-:arg ope_for:-:A return:-:A
how mani river are in the state with the highest point ?	add_operation:-:_count add_node:-:B add_type_node:-:_river arg_node:-:B add_node:-:C add_edge:-:_loc arg_node:-:B arg_node:-:C add_type_node:-:_state arg_node:-:C add_node:-:D add_edge:-:_loc arg_node:-:D arg_node:-:C add_operation:-:_highest add_type_node:-:_place arg_node:-:D end_operation:-:arg ope_for:-:D end_operation:-:_count ope_for:-:B ope_return:-:A return:-:A
what citi are locat in pennsylvania ?	add_node:-:A add_type_node:-:_city arg_node:-:A add_node:-:B add_edge:-:_loc arg_node:-:A arg_node:-:B add_entity_node:-:pennsylvania:=:state arg_node:-:B return:-:A
what is the state with the lowest popul ?	add_operation:-:_smallest add_node:-:A add_type_node:-:_state arg_node:-:A add_node:-:B add_edge:-:_population arg_node:-:A arg_node:-:B end_operation:-:arg ope_for:-:B return:-:A
what is the highest point in each state whose lowest point is sea level ?	add_node:-:B add_node:-:A add_edge:-:_high_point arg_node:-:B arg_node:-:A add_type_node:-:_state arg_node:-:B add_node:-:C add_edge:-:_low_point arg_node:-:B arg_node:-:C add_type_node:-:_elevation arg_node:-:C return:-:A
give me the citi in usa ?	add_node:-:A add_type_node:-:_city arg_node:-:A add_node:-:B add_edge:-:_loc arg_node:-:A arg_node:-:B add_entity_node:-:usa:=:country arg_node:-:B return:-:A
how mani state doe the missouri river run through ?	add_operation:-:_count add_node:-:B add_type_node:-:_state arg_node:-:B add_node:-:C add_edge:-:_traverse arg_node:-:C arg_node:-:B add_entity_node:-:missouri:=:river arg_node:-:C add_type_node:-:_river arg_node:-:C end_operation:-:_count ope_for:-:B ope_return:-:A return:-:A
what state has the citi with the largest popul ?	add_node:-:A add_type_node:-:_state arg_node:-:A add_node:-:B add_edge:-:_loc arg_node:-:B arg_node:-:A add_operation:-:_largest add_type_node:-:_city arg_node:-:B add_node:-:C add_edge:-:_population arg_node:-:B arg_node:-:C end_operation:-:arg ope_for:-:C return:-:A
which is the shortest river ?	add_operation:-:_shortest add_node:-:A add_type_node:-:_river arg_node:-:A end_operation:-:arg ope_for:-:A return:-:A
how mani state border alaska ?	add_operation:-:_count add_node:-:B add_type_node:-:_state arg_node:-:B add_node:-:C add_edge:-:_next_to arg_node:-:B arg_node:-:C add_entity_node:-:alaska:=:state arg_node:-:C end_operation:-:_count ope_for:-:B ope_return:-:A return:-:A
what is the popul of dallas ?	add_node:-:B add_node:-:A add_edge:-:_population arg_node:-:B arg_node:-:A add_entity_node:-:dallas:=:city arg_node:-:B return:-:A
where is san jose ?	add_node:-:B add_node:-:A add_edge:-:_loc arg_node:-:B arg_node:-:A add_entity_node:-:san_jose:=:city arg_node:-:B return:-:A
what state border state that border colorado ?	add_node:-:A add_type_node:-:_state arg_node:-:A add_node:-:B add_edge:-:_next_to arg_node:-:A arg_node:-:B add_type_node:-:_state arg_node:-:B add_node:-:C add_edge:-:_next_to arg_node:-:B arg_node:-:C add_entity_node:-:colorado:=:state arg_node:-:C return:-:A
what river flow through the state with the largest popul ?	add_node:-:A add_type_node:-:_river arg_node:-:A add_node:-:B add_edge:-:_traverse arg_node:-:A arg_node:-:B add_operation:-:_largest add_type_node:-:_state arg_node:-:B add_node:-:C add_edge:-:_population arg_node:-:B arg_node:-:C end_operation:-:arg ope_for:-:C return:-:A
what the largest citi ?	add_operation:-:_largest add_node:-:A add_type_node:-:_city arg_node:-:A end_operation:-:arg ope_for:-:A return:-:A
what is the capit of the alabama state ?	add_node:-:A add_type_node:-:_capital arg_node:-:A add_node:-:B add_edge:-:_loc arg_node:-:A arg_node:-:B add_entity_node:-:alabama:=:state arg_node:-:B add_type_node:-:_state arg_node:-:B return:-:A
what state border arkansas ?	add_node:-:A add_type_node:-:_state arg_node:-:A add_node:-:B add_edge:-:_next_to arg_node:-:A arg_node:-:B add_entity_node:-:arkansas:=:state arg_node:-:B return:-:A
what is the popul of denver ?	add_node:-:B add_node:-:A add_edge:-:_population arg_node:-:B arg_node:-:A add_entity_node:-:denver:=:city arg_node:-:B return:-:A
what is the longest river in america ?	add_operation:-:_longest add_node:-:A add_type_node:-:_river arg_node:-:A add_node:-:B add_edge:-:_loc arg_node:-:A arg_node:-:B add_entity_node:-:usa:=:country arg_node:-:B end_operation:-:arg ope_for:-:A return:-:A
where is massachusetts ?	add_node:-:B add_node:-:A add_edge:-:_loc arg_node:-:B arg_node:-:A add_entity_node:-:massachusetts:=:state arg_node:-:B return:-:A
what state has the smallest area ?	add_operation:-:_smallest add_node:-:A add_type_node:-:_state arg_node:-:A add_node:-:B add_edge:-:_area arg_node:-:A arg_node:-:B end_operation:-:arg ope_for:-:B return:-:A
what major river run through illinois ?	add_node:-:A add_type_node:-:_major arg_node:-:A add_type_node:-:_river arg_node:-:A add_node:-:B add_edge:-:_traverse arg_node:-:A arg_node:-:B add_entity_node:-:illinois:=:state arg_node:-:B return:-:A
how mani citi doe the usa have ?	add_operation:-:_count add_node:-:B add_type_node:-:_city arg_node:-:B add_node:-:C add_edge:-:_loc arg_node:-:B arg_node:-:C add_entity_node:-:usa:=:country arg_node:-:C end_operation:-:_count ope_for:-:B ope_return:-:A return:-:A
how mani peopl live in california ?	add_node:-:B add_node:-:A add_edge:-:_population arg_node:-:B arg_node:-:A add_entity_node:-:california:=:state arg_node:-:B return:-:A
what are the major river in the us ?	add_node:-:A add_type_node:-:_major arg_node:-:A add_type_node:-:_river arg_node:-:A add_node:-:B add_edge:-:_loc arg_node:-:A arg_node:-:B add_entity_node:-:usa:=:country arg_node:-:B return:-:A
how mani state doe the mississippi river run through ?	add_operation:-:_count add_node:-:B add_type_node:-:_state arg_node:-:B add_node:-:C add_edge:-:_traverse arg_node:-:C arg_node:-:B add_entity_node:-:mississippi:=:river arg_node:-:C add_type_node:-:_river arg_node:-:C end_operation:-:_count ope_for:-:B ope_return:-:A return:-:A
what is the area of texas ?	add_node:-:B add_node:-:A add_edge:-:_area arg_node:-:B arg_node:-:A add_entity_node:-:texas:=:state arg_node:-:B return:-:A
what is the length of the river that travers the most state ?	add_node:-:B add_node:-:A add_edge:-:_len arg_node:-:B arg_node:-:A add_operation:-:_most add_type_node:-:_river arg_node:-:B add_node:-:C add_edge:-:_traverse arg_node:-:B arg_node:-:C add_type_node:-:_state arg_node:-:C end_operation:-:arg_count ope_for:-:B ope_for:-:C return:-:A
what is the length of the longest river in the usa ?	add_node:-:B add_node:-:A add_edge:-:_len arg_node:-:B arg_node:-:A add_operation:-:_longest add_type_node:-:_river arg_node:-:B add_node:-:C add_edge:-:_loc arg_node:-:B arg_node:-:C add_entity_node:-:usa:=:country arg_node:-:C end_operation:-:arg ope_for:-:B return:-:A
can you tell me the capit of texas ?	add_node:-:A add_type_node:-:_capital arg_node:-:A add_node:-:B add_edge:-:_loc arg_node:-:A arg_node:-:B add_entity_node:-:texas:=:state arg_node:-:B return:-:A
what is the largest citi in minnesota by popul ?	add_operation:-:_largest add_node:-:A add_type_node:-:_city arg_node:-:A add_node:-:C add_edge:-:_loc arg_node:-:A arg_node:-:C add_entity_node:-:minnesota:=:state arg_node:-:C add_node:-:B add_edge:-:_population arg_node:-:A arg_node:-:B end_operation:-:arg ope_for:-:B return:-:A
what is the smallest state in the usa ?	add_operation:-:_smallest add_node:-:A add_type_node:-:_state arg_node:-:A add_node:-:B add_edge:-:_loc arg_node:-:A arg_node:-:B add_entity_node:-:usa:=:country arg_node:-:B end_operation:-:arg ope_for:-:A return:-:A
what state neighbor maine ?	add_node:-:A add_type_node:-:_state arg_node:-:A add_node:-:B add_edge:-:_next_to arg_node:-:A arg_node:-:B add_entity_node:-:maine:=:state arg_node:-:B return:-:A
what state high point are higher than that of colorado ?	add_node:-:A add_type_node:-:_state arg_node:-:A add_node:-:B add_edge:-:_high_point arg_node:-:A arg_node:-:B add_node:-:C add_edge:-:_higher arg_node:-:B arg_node:-:C add_node:-:D add_edge:-:_high_point arg_node:-:D arg_node:-:C add_entity_node:-:colorado:=:state arg_node:-:D return:-:A
what is the highest mountain in texas ?	add_operation:-:_highest add_node:-:A add_type_node:-:_mountain arg_node:-:A add_node:-:B add_edge:-:_loc arg_node:-:A arg_node:-:B add_entity_node:-:texas:=:state arg_node:-:B end_operation:-:arg ope_for:-:A return:-:A
what are the major citi in texas ?	add_node:-:A add_type_node:-:_major arg_node:-:A add_type_node:-:_city arg_node:-:A add_node:-:B add_edge:-:_loc arg_node:-:A arg_node:-:B add_entity_node:-:texas:=:state arg_node:-:B return:-:A
what are the state that border the state with the greatest popul ?	add_node:-:A add_type_node:-:_state arg_node:-:A add_node:-:B add_edge:-:_next_to arg_node:-:B arg_node:-:A add_operation:-:_largest add_type_node:-:_state arg_node:-:B add_node:-:C add_edge:-:_population arg_node:-:B arg_node:-:C end_operation:-:arg ope_for:-:C return:-:A
what river run through colorado ?	add_node:-:A add_type_node:-:_river arg_node:-:A add_node:-:B add_edge:-:_traverse arg_node:-:A arg_node:-:B add_entity_node:-:colorado:=:state arg_node:-:B return:-:A
how mani river are there in us ?	add_operation:-:_count add_node:-:B add_type_node:-:_river arg_node:-:B add_node:-:C add_edge:-:_loc arg_node:-:B arg_node:-:C add_entity_node:-:usa:=:country arg_node:-:C end_operation:-:_count ope_for:-:B ope_return:-:A return:-:A
how mani river are in new york ?	add_operation:-:_count add_node:-:B add_type_node:-:_river arg_node:-:B add_node:-:C add_edge:-:_loc arg_node:-:B arg_node:-:C add_entity_node:-:new_york:=:state arg_node:-:C end_operation:-:_count ope_for:-:B ope_return:-:A return:-:A
which river are in alaska ?	add_node:-:A add_type_node:-:_river arg_node:-:A add_node:-:B add_edge:-:_loc arg_node:-:A arg_node:-:B add_entity_node:-:alaska:=:state arg_node:-:B return:-:A
what is the longest river flow through new york ?	add_operation:-:_longest add_node:-:A add_type_node:-:_river arg_node:-:A add_node:-:B add_edge:-:_traverse arg_node:-:A arg_node:-:B add_entity_node:-:new_york:=:state arg_node:-:B end_operation:-:arg ope_for:-:A return:-:A
what river run through west virginia ?	add_node:-:A add_type_node:-:_river arg_node:-:A add_node:-:B add_edge:-:_traverse arg_node:-:A arg_node:-:B add_entity_node:-:west_virginia:=:state arg_node:-:B return:-:A
what are the capit of the state that border texas ?	add_node:-:A add_type_node:-:_capital arg_node:-:A add_node:-:B add_edge:-:_loc arg_node:-:A arg_node:-:B add_type_node:-:_state arg_node:-:B add_node:-:C add_edge:-:_next_to arg_node:-:B arg_node:-:C add_entity_node:-:texas:=:state arg_node:-:C return:-:A
what is the area of california ?	add_node:-:B add_node:-:A add_edge:-:_area arg_node:-:B arg_node:-:A add_entity_node:-:california:=:state arg_node:-:B return:-:A
how mani state have a citi name springfield ?	add_operation:-:_count add_node:-:B add_type_node:-:_state arg_node:-:B add_node:-:C add_edge:-:_loc arg_node:-:C arg_node:-:B add_entity_node:-:springfield:=:city arg_node:-:C end_operation:-:_count ope_for:-:B ope_return:-:A return:-:A
what is the biggest citi in texas ?	add_operation:-:_largest add_node:-:A add_type_node:-:_city arg_node:-:A add_node:-:B add_edge:-:_loc arg_node:-:A arg_node:-:B add_entity_node:-:texas:=:state arg_node:-:B end_operation:-:arg ope_for:-:A return:-:A
how mani citi name austin are there in the usa ?	add_operation:-:_count add_node:-:B add_type_node:-:_city arg_node:-:B add_entity_node:-:austin:=:city arg_node:-:B add_node:-:C add_edge:-:_loc arg_node:-:B arg_node:-:C add_entity_node:-:usa:=:country arg_node:-:C end_operation:-:_count ope_for:-:B ope_return:-:A return:-:A
what are the major citi in the largest state ?	add_node:-:A add_type_node:-:_major arg_node:-:A add_type_node:-:_city arg_node:-:A add_node:-:B add_edge:-:_loc arg_node:-:A arg_node:-:B add_operation:-:_largest add_type_node:-:_state arg_node:-:B end_operation:-:arg ope_for:-:B return:-:A
which state doe the colorado river run through ?	add_node:-:A add_type_node:-:_state arg_node:-:A add_node:-:B add_edge:-:_traverse arg_node:-:B arg_node:-:A add_entity_node:-:colorado:=:river arg_node:-:B return:-:A
what is the largest citi in wisconsin ?	add_operation:-:_largest add_node:-:A add_type_node:-:_city arg_node:-:A add_node:-:B add_edge:-:_loc arg_node:-:A arg_node:-:B add_entity_node:-:wisconsin:=:state arg_node:-:B end_operation:-:arg ope_for:-:A return:-:A
how big is alaska ?	add_node:-:B add_node:-:A add_edge:-:_size arg_node:-:B arg_node:-:A add_entity_node:-:alaska:=:state arg_node:-:B return:-:A
what state contain the highest point in the us ?	add_node:-:A add_type_node:-:_state arg_node:-:A add_node:-:B add_edge:-:_loc arg_node:-:B arg_node:-:A add_operation:-:_highest add_type_node:-:_place arg_node:-:B add_node:-:C add_edge:-:_loc arg_node:-:B arg_node:-:C add_entity_node:-:usa:=:country arg_node:-:C end_operation:-:arg ope_for:-:B return:-:A
how big is north dakota ?	add_node:-:B add_node:-:A add_edge:-:_size arg_node:-:B arg_node:-:A add_entity_node:-:north_dakota:=:state arg_node:-:B return:-:A
which river flow through alaska ?	add_node:-:A add_type_node:-:_river arg_node:-:A add_node:-:B add_edge:-:_traverse arg_node:-:A arg_node:-:B add_entity_node:-:alaska:=:state arg_node:-:B return:-:A
what is the highest point in the us ?	add_operation:-:_highest add_node:-:A add_type_node:-:_place arg_node:-:A add_node:-:B add_edge:-:_loc arg_node:-:A arg_node:-:B add_entity_node:-:usa:=:country arg_node:-:B end_operation:-:arg ope_for:-:A return:-:A
what is the shortest river in texas ?	add_operation:-:_shortest add_node:-:A add_type_node:-:_river arg_node:-:A add_node:-:B add_edge:-:_loc arg_node:-:A arg_node:-:B add_entity_node:-:texas:=:state arg_node:-:B end_operation:-:arg ope_for:-:A return:-:A
what are the major citi in the state through which the major river in virginia run ?	add_node:-:A add_type_node:-:_major arg_node:-:A add_type_node:-:_city arg_node:-:A add_node:-:B add_edge:-:_loc arg_node:-:A arg_node:-:B add_type_node:-:_state arg_node:-:B add_node:-:C add_edge:-:_traverse arg_node:-:C arg_node:-:B add_type_node:-:_river arg_node:-:C add_node:-:D add_edge:-:_loc arg_node:-:C arg_node:-:D add_entity_node:-:virginia:=:state arg_node:-:D return:-:A
what river are in oregon ?	add_node:-:A add_type_node:-:_river arg_node:-:A add_node:-:B add_edge:-:_loc arg_node:-:A arg_node:-:B add_entity_node:-:oregon:=:state arg_node:-:B return:-:A
what is the lowest point in the united states ?	add_operation:-:_lowest add_node:-:A add_type_node:-:_place arg_node:-:A add_node:-:B add_edge:-:_loc arg_node:-:A arg_node:-:B add_entity_node:-:usa:=:country arg_node:-:B end_operation:-:arg ope_for:-:A return:-:A
how mani state have citi or town name springfield ?	add_operation:-:_count add_node:-:B add_type_node:-:_state arg_node:-:B add_node:-:C add_edge:-:_loc arg_node:-:C arg_node:-:B add_type_node:-:_city arg_node:-:C add_entity_node:-:springfield:=:city arg_node:-:C end_operation:-:_count ope_for:-:B ope_return:-:A return:-:A
what is the popul of south dakota ?	add_node:-:B add_node:-:A add_edge:-:_population arg_node:-:B arg_node:-:A add_entity_node:-:south_dakota:=:state arg_node:-:B return:-:A
what is the capit of the state with the highest point ?	add_node:-:A add_type_node:-:_capital arg_node:-:A add_node:-:B add_edge:-:_loc arg_node:-:A arg_node:-:B add_operation:-:_highest add_type_node:-:_state arg_node:-:B add_node:-:C add_edge:-:_loc arg_node:-:C arg_node:-:B add_type_node:-:_place arg_node:-:C end_operation:-:arg ope_for:-:C return:-:A
what state has the highest elev ?	add_operation:-:_highest add_node:-:A add_type_node:-:_state arg_node:-:A add_node:-:B add_edge:-:_loc arg_node:-:B arg_node:-:A add_type_node:-:_place arg_node:-:B end_operation:-:arg ope_for:-:B return:-:A
what state are next to texas ?	add_node:-:A add_type_node:-:_state arg_node:-:A add_node:-:B add_edge:-:_next_to arg_node:-:A arg_node:-:B add_entity_node:-:texas:=:state arg_node:-:B return:-:A
what is the longest river that pass the state that border the state that border the most state ?	add_operation:-:_longest add_node:-:A add_type_node:-:_river arg_node:-:A add_node:-:B add_edge:-:_traverse arg_node:-:A arg_node:-:B add_type_node:-:_state arg_node:-:B add_node:-:C add_edge:-:_next_to arg_node:-:B arg_node:-:C add_operation:-:_most add_type_node:-:_state arg_node:-:C add_node:-:D add_edge:-:_next_to arg_node:-:C arg_node:-:D add_type_node:-:_state arg_node:-:D end_operation:-:arg_count ope_for:-:C ope_for:-:D end_operation:-:arg ope_for:-:A return:-:A
which state border hawaii ?	add_node:-:A add_type_node:-:_state arg_node:-:A add_node:-:B add_edge:-:_next_to arg_node:-:A arg_node:-:B add_entity_node:-:hawaii:=:state arg_node:-:B return:-:A
how mani major citi are there in oregon ?	add_operation:-:_count add_node:-:B add_type_node:-:_major arg_node:-:B add_type_node:-:_city arg_node:-:B add_node:-:C add_edge:-:_loc arg_node:-:B arg_node:-:C add_entity_node:-:oregon:=:state arg_node:-:C end_operation:-:_count ope_for:-:B ope_return:-:A return:-:A
what is the popul of springfield south dakota ?	add_node:-:B add_node:-:A add_edge:-:_population arg_node:-:B arg_node:-:A add_entity_node:-:springfield_sd:=:city arg_node:-:B return:-:A
how mani river run through texas ?	add_operation:-:_count add_node:-:B add_type_node:-:_river arg_node:-:B add_node:-:C add_edge:-:_traverse arg_node:-:B arg_node:-:C add_entity_node:-:texas:=:state arg_node:-:C end_operation:-:_count ope_for:-:B ope_return:-:A return:-:A
what state has the most major river run through it ?	add_operation:-:_most add_node:-:A add_type_node:-:_state arg_node:-:A add_node:-:B add_edge:-:_loc arg_node:-:B arg_node:-:A add_type_node:-:_major arg_node:-:B add_type_node:-:_river arg_node:-:B add_edge:-:_traverse arg_node:-:B arg_node:-:A end_operation:-:arg_count ope_for:-:A ope_for:-:B return:-:A
what are the lake in state border texas ?	add_node:-:A add_type_node:-:_lake arg_node:-:A add_node:-:B add_edge:-:_loc arg_node:-:A arg_node:-:B add_type_node:-:_state arg_node:-:B add_node:-:C add_edge:-:_next_to arg_node:-:B arg_node:-:C add_entity_node:-:texas:=:state arg_node:-:C return:-:A
peopl in boulder ?	add_node:-:B add_node:-:A add_edge:-:_population arg_node:-:B arg_node:-:A add_entity_node:-:boulder:=:city arg_node:-:B return:-:A
what river are in nevada ?	add_node:-:A add_type_node:-:_river arg_node:-:A add_node:-:B add_edge:-:_loc arg_node:-:A arg_node:-:B add_entity_node:-:nevada:=:state arg_node:-:B return:-:A
where is fort wayne ?	add_node:-:B add_node:-:A add_edge:-:_loc arg_node:-:B arg_node:-:A add_entity_node:-:fort_wayne:=:city arg_node:-:B return:-:A
where is indianapolis ?	add_node:-:B add_node:-:A add_edge:-:_loc arg_node:-:B arg_node:-:A add_entity_node:-:indianapolis:=:city arg_node:-:B return:-:A
what state border state that border state that border state that border texas ?	add_node:-:A add_type_node:-:_state arg_node:-:A add_node:-:B add_edge:-:_next_to arg_node:-:A arg_node:-:B add_type_node:-:_state arg_node:-:B add_node:-:C add_edge:-:_next_to arg_node:-:B arg_node:-:C add_type_node:-:_state arg_node:-:C add_node:-:D add_edge:-:_next_to arg_node:-:C arg_node:-:D add_type_node:-:_state arg_node:-:D add_node:-:E add_edge:-:_next_to arg_node:-:D arg_node:-:E add_entity_node:-:texas:=:state arg_node:-:E return:-:A
popul of boulder ?	add_node:-:B add_node:-:A add_edge:-:_population arg_node:-:B arg_node:-:A add_entity_node:-:boulder:=:city arg_node:-:B return:-:A
what are the major citi of the united states ?	add_node:-:A add_type_node:-:_major arg_node:-:A add_type_node:-:_city arg_node:-:A add_node:-:B add_edge:-:_loc arg_node:-:A arg_node:-:B add_entity_node:-:usa:=:country arg_node:-:B return:-:A
show major citi in colorado ?	add_node:-:A add_type_node:-:_major arg_node:-:A add_type_node:-:_city arg_node:-:A add_node:-:B add_edge:-:_loc arg_node:-:A arg_node:-:B add_entity_node:-:colorado:=:state arg_node:-:B return:-:A
what state is columbus the capit of ?	add_node:-:A add_type_node:-:_state arg_node:-:A add_node:-:B add_edge:-:_loc arg_node:-:B arg_node:-:A add_entity_node:-:columbus:=:city arg_node:-:B add_type_node:-:_capital arg_node:-:B return:-:A
what is the area of all the state combin ?	add_operation:-:_sum add_node:-:C add_type_node:-:_state arg_node:-:C add_type_node:-:_area arg_node:-:C end_operation:-:_sum ope_for:-:C ope_in:-:_area ope_return:-:A return:-:A
what is the averag popul per squar km in the us ?	add_node:-:B add_node:-:A add_edge:-:_density arg_node:-:B arg_node:-:A add_entity_node:-:usa:=:country arg_node:-:B return:-:A
what is the largest state that border california ?	add_operation:-:_largest add_node:-:A add_type_node:-:_state arg_node:-:A add_node:-:B add_edge:-:_next_to arg_node:-:A arg_node:-:B add_entity_node:-:california:=:state arg_node:-:B end_operation:-:arg ope_for:-:A return:-:A
what is the popul of montana ?	add_node:-:B add_node:-:A add_edge:-:_population arg_node:-:B arg_node:-:A add_entity_node:-:montana:=:state arg_node:-:B return:-:A
what are the popul of all the major citi in montana ?	add_node:-:B add_node:-:A add_edge:-:_population arg_node:-:B arg_node:-:A add_type_node:-:_major arg_node:-:B add_type_node:-:_city arg_node:-:B add_node:-:C add_edge:-:_loc arg_node:-:B arg_node:-:C add_entity_node:-:montana:=:state arg_node:-:C return:-:A
which river run through the state with the lowest elev in the usa ?	add_node:-:A add_type_node:-:_river arg_node:-:A add_node:-:B add_edge:-:_traverse arg_node:-:A arg_node:-:B add_type_node:-:_state arg_node:-:B add_node:-:C add_edge:-:_loc arg_node:-:C arg_node:-:B add_operation:-:_lowest add_type_node:-:_place arg_node:-:C add_node:-:D add_edge:-:_loc arg_node:-:C arg_node:-:D add_entity_node:-:usa:=:country arg_node:-:D end_operation:-:arg ope_for:-:C return:-:A
what river flow through the largest state ?	add_node:-:A add_type_node:-:_river arg_node:-:A add_node:-:B add_edge:-:_traverse arg_node:-:A arg_node:-:B add_operation:-:_largest add_type_node:-:_state arg_node:-:B end_operation:-:arg ope_for:-:B return:-:A
what is the area of maine ?	add_node:-:B add_node:-:A add_edge:-:_area arg_node:-:B arg_node:-:A add_entity_node:-:maine:=:state arg_node:-:B return:-:A
what are major river in texas ?	add_node:-:A add_type_node:-:_major arg_node:-:A add_type_node:-:_river arg_node:-:A add_node:-:B add_edge:-:_loc arg_node:-:A arg_node:-:B add_entity_node:-:texas:=:state arg_node:-:B return:-:A
what is the popul densiti of the state with the smallest popul ?	add_node:-:B add_node:-:A add_edge:-:_density arg_node:-:B arg_node:-:A add_operation:-:_smallest add_type_node:-:_state arg_node:-:B add_node:-:C add_edge:-:_population arg_node:-:B arg_node:-:C end_operation:-:arg ope_for:-:C return:-:A
what is the highest point in wyoming ?	add_operation:-:_highest add_node:-:A add_type_node:-:_place arg_node:-:A add_node:-:B add_edge:-:_loc arg_node:-:A arg_node:-:B add_entity_node:-:wyoming:=:state arg_node:-:B end_operation:-:arg ope_for:-:A return:-:A
what state border delaware ?	add_node:-:A add_type_node:-:_state arg_node:-:A add_node:-:B add_edge:-:_next_to arg_node:-:A arg_node:-:B add_entity_node:-:delaware:=:state arg_node:-:B return:-:A
which state has the most river run through it ?	add_operation:-:_most add_node:-:A add_type_node:-:_state arg_node:-:A add_node:-:B add_edge:-:_loc arg_node:-:B arg_node:-:A add_type_node:-:_river arg_node:-:B add_edge:-:_traverse arg_node:-:B arg_node:-:A end_operation:-:arg_count ope_for:-:A ope_for:-:B return:-:A
what is largest capit ?	add_operation:-:_largest add_node:-:A add_type_node:-:_capital arg_node:-:A end_operation:-:arg ope_for:-:A return:-:A
what is the state with the largest popul densiti ?	add_operation:-:_largest add_node:-:A add_type_node:-:_state arg_node:-:A add_node:-:B add_edge:-:_density arg_node:-:A arg_node:-:B end_operation:-:arg ope_for:-:B return:-:A
what state have town name springfield ?	add_node:-:A add_type_node:-:_state arg_node:-:A add_node:-:B add_edge:-:_loc arg_node:-:B arg_node:-:A add_entity_node:-:springfield:=:city arg_node:-:B return:-:A
what is the smallest citi in the largest state ?	add_operation:-:_smallest add_node:-:A add_type_node:-:_city arg_node:-:A add_node:-:B add_edge:-:_loc arg_node:-:A arg_node:-:B add_operation:-:_largest add_type_node:-:_state arg_node:-:B end_operation:-:arg ope_for:-:B end_operation:-:arg ope_for:-:A return:-:A
what mountain are in alaska ?	add_node:-:A add_type_node:-:_mountain arg_node:-:A add_node:-:B add_edge:-:_loc arg_node:-:A arg_node:-:B add_entity_node:-:alaska:=:state arg_node:-:B return:-:A
what river flow through colorado ?	add_node:-:A add_type_node:-:_river arg_node:-:A add_node:-:B add_edge:-:_traverse arg_node:-:A arg_node:-:B add_entity_node:-:colorado:=:state arg_node:-:B return:-:A
which state has the least popul densiti ?	add_operation:-:_smallest add_node:-:A add_type_node:-:_state arg_node:-:A add_node:-:B add_edge:-:_density arg_node:-:A arg_node:-:B end_operation:-:arg ope_for:-:B return:-:A
how mani inhabit doe montgomery have ?	add_node:-:B add_node:-:A add_edge:-:_population arg_node:-:B arg_node:-:A add_entity_node:-:montgomery:=:city arg_node:-:B return:-:A
what citi has the largest popul ?	add_operation:-:_largest add_node:-:A add_type_node:-:_city arg_node:-:A add_node:-:B add_edge:-:_population arg_node:-:A arg_node:-:B end_operation:-:arg ope_for:-:B return:-:A
what is the largest state ?	add_operation:-:_largest add_node:-:A add_type_node:-:_state arg_node:-:A end_operation:-:arg ope_for:-:A return:-:A
of the state wash by the mississippi river which has the lowest point ?	add_operation:-:_lowest add_node:-:A add_type_node:-:_state arg_node:-:A add_node:-:C add_edge:-:_traverse arg_node:-:C arg_node:-:A add_entity_node:-:mississippi:=:river arg_node:-:C add_node:-:B add_edge:-:_loc arg_node:-:B arg_node:-:A add_type_node:-:_place arg_node:-:B end_operation:-:arg ope_for:-:B return:-:A
what is the area of the state with the smallest popul densiti ?	add_node:-:B add_node:-:A add_edge:-:_area arg_node:-:B arg_node:-:A add_operation:-:_smallest add_type_node:-:_state arg_node:-:B add_node:-:C add_edge:-:_density arg_node:-:B arg_node:-:C end_operation:-:arg ope_for:-:C return:-:A
which state contain most river ?	add_operation:-:_most add_node:-:A add_type_node:-:_state arg_node:-:A add_node:-:B add_edge:-:_loc arg_node:-:B arg_node:-:A add_type_node:-:_river arg_node:-:B end_operation:-:arg_count ope_for:-:A ope_for:-:B return:-:A
what is the longest river in mississippi ?	add_operation:-:_longest add_node:-:A add_type_node:-:_river arg_node:-:A add_node:-:B add_edge:-:_loc arg_node:-:A arg_node:-:B add_entity_node:-:mississippi:=:state arg_node:-:B end_operation:-:arg ope_for:-:A return:-:A
what is the capit of the largest state ?	add_node:-:A add_type_node:-:_capital arg_node:-:A add_node:-:B add_edge:-:_loc arg_node:-:A arg_node:-:B add_operation:-:_largest add_type_node:-:_state arg_node:-:B end_operation:-:arg ope_for:-:B return:-:A
what state has the largest popul ?	add_operation:-:_largest add_node:-:A add_type_node:-:_state arg_node:-:A add_node:-:B add_edge:-:_population arg_node:-:A arg_node:-:B end_operation:-:arg ope_for:-:B return:-:A
name the river in arkansas ?	add_node:-:A add_type_node:-:_river arg_node:-:A add_node:-:B add_edge:-:_loc arg_node:-:A arg_node:-:B add_entity_node:-:arkansas:=:state arg_node:-:B return:-:A
what are the popul of state through which the mississippi run ?	add_node:-:B add_node:-:A add_edge:-:_population arg_node:-:B arg_node:-:A add_type_node:-:_state arg_node:-:B add_node:-:C add_edge:-:_traverse arg_node:-:C arg_node:-:B add_entity_node:-:mississippi:=:river arg_node:-:C return:-:A
what is the popul of arizona ?	add_node:-:B add_node:-:A add_edge:-:_population arg_node:-:B arg_node:-:A add_entity_node:-:arizona:=:state arg_node:-:B return:-:A
what state border the state with the smallest popul ?	add_node:-:A add_type_node:-:_state arg_node:-:A add_node:-:B add_edge:-:_next_to arg_node:-:A arg_node:-:B add_operation:-:_smallest add_type_node:-:_state arg_node:-:B add_node:-:C add_edge:-:_population arg_node:-:B arg_node:-:C end_operation:-:arg ope_for:-:C return:-:A
what is the total area of the usa ?	add_node:-:B add_node:-:A add_edge:-:_area arg_node:-:B arg_node:-:A add_entity_node:-:usa:=:country arg_node:-:B return:-:A
what is the popul of seattle washington ?	add_node:-:B add_node:-:A add_edge:-:_population arg_node:-:B arg_node:-:A add_entity_node:-:seattle_wa:=:city arg_node:-:B return:-:A
what is the size of the largest state in the usa ?	add_node:-:B add_node:-:A add_edge:-:_size arg_node:-:B arg_node:-:A add_operation:-:_largest add_type_node:-:_state arg_node:-:B add_node:-:C add_edge:-:_loc arg_node:-:B arg_node:-:C add_entity_node:-:usa:=:country arg_node:-:C end_operation:-:arg ope_for:-:B return:-:A
what state has the capit salem ?	add_node:-:A add_type_node:-:_state arg_node:-:A add_node:-:B add_edge:-:_loc arg_node:-:B arg_node:-:A add_type_node:-:_capital arg_node:-:B add_entity_node:-:salem:=:city arg_node:-:B return:-:A
which is the lowest point of the state that the mississippi runs through ?	add_operation:-:_lowest add_node:-:B add_type_node:-:_place arg_node:-:B add_node:-:A add_edge:-:_loc arg_node:-:B arg_node:-:A add_type_node:-:_state arg_node:-:A add_node:-:C add_edge:-:_traverse arg_node:-:C arg_node:-:A add_entity_node:-:mississippi:=:river arg_node:-:C end_operation:-:arg ope_for:-:B return:-:B
how mani major citi are in texas ?	add_operation:-:_count add_node:-:B add_type_node:-:_major arg_node:-:B add_type_node:-:_city arg_node:-:B add_node:-:C add_edge:-:_loc arg_node:-:B arg_node:-:C add_entity_node:-:texas:=:state arg_node:-:C end_operation:-:_count ope_for:-:B ope_return:-:A return:-:A
what is the capit citi of the largest state in the us ?	add_node:-:A add_type_node:-:_capital arg_node:-:A add_type_node:-:_city arg_node:-:A add_node:-:B add_edge:-:_loc arg_node:-:A arg_node:-:B add_operation:-:_largest add_type_node:-:_state arg_node:-:B add_node:-:C add_edge:-:_loc arg_node:-:B arg_node:-:C add_entity_node:-:usa:=:country arg_node:-:C end_operation:-:arg ope_for:-:B return:-:A
what are the major citi in rhode island ?	add_node:-:A add_type_node:-:_major arg_node:-:A add_type_node:-:_city arg_node:-:A add_node:-:B add_edge:-:_loc arg_node:-:A arg_node:-:B add_entity_node:-:rhode_island:=:state arg_node:-:B return:-:A
what state has the most peopl ?	add_operation:-:_largest add_node:-:A add_type_node:-:_state arg_node:-:A add_node:-:B add_edge:-:_population arg_node:-:A arg_node:-:B end_operation:-:arg ope_for:-:B return:-:A
what is the largest citi of kansas ?	add_operation:-:_largest add_node:-:A add_type_node:-:_city arg_node:-:A add_node:-:B add_edge:-:_loc arg_node:-:A arg_node:-:B add_entity_node:-:kansas:=:state arg_node:-:B end_operation:-:arg ope_for:-:A return:-:A
what is the area of the state with the capit albany ?	add_node:-:B add_node:-:A add_edge:-:_area arg_node:-:B arg_node:-:A add_type_node:-:_state arg_node:-:B add_node:-:C add_edge:-:_loc arg_node:-:C arg_node:-:B add_type_node:-:_capital arg_node:-:C add_entity_node:-:albany:=:city arg_node:-:C return:-:A
what is the longest river that flow through colorado ?	add_operation:-:_longest add_node:-:A add_type_node:-:_river arg_node:-:A add_node:-:B add_edge:-:_traverse arg_node:-:A arg_node:-:B add_entity_node:-:colorado:=:state arg_node:-:B end_operation:-:arg ope_for:-:A return:-:A
how mani river doe alaska have ?	add_operation:-:_count add_node:-:B add_type_node:-:_river arg_node:-:B add_node:-:C add_edge:-:_loc arg_node:-:B arg_node:-:C add_entity_node:-:alaska:=:state arg_node:-:C end_operation:-:_count ope_for:-:B ope_return:-:A return:-:A
how big is massachusetts ?	add_node:-:B add_node:-:A add_edge:-:_size arg_node:-:B arg_node:-:A add_entity_node:-:massachusetts:=:state arg_node:-:B return:-:A
how larg is the largest citi in alaska ?	add_node:-:B add_node:-:A add_edge:-:_size arg_node:-:B arg_node:-:A add_operation:-:_largest add_type_node:-:_city arg_node:-:B add_node:-:C add_edge:-:_loc arg_node:-:B arg_node:-:C add_entity_node:-:alaska:=:state arg_node:-:C end_operation:-:arg ope_for:-:B return:-:A
how mani citi are there in usa ?	add_operation:-:_count add_node:-:B add_type_node:-:_city arg_node:-:B add_node:-:C add_edge:-:_loc arg_node:-:B arg_node:-:C add_entity_node:-:usa:=:country arg_node:-:C end_operation:-:_count ope_for:-:B ope_return:-:A return:-:A
what state capit is dover ?	add_node:-:A add_type_node:-:_state arg_node:-:A add_node:-:B add_edge:-:_capital arg_node:-:A arg_node:-:B add_entity_node:-:dover:=:city arg_node:-:B return:-:A
what state border new hampshire ?	add_node:-:A add_type_node:-:_state arg_node:-:A add_node:-:B add_edge:-:_next_to arg_node:-:A arg_node:-:B add_entity_node:-:new_hampshire:=:state arg_node:-:B return:-:A
what is the shortest river in nebraska ?	add_operation:-:_shortest add_node:-:A add_type_node:-:_river arg_node:-:A add_node:-:B add_edge:-:_loc arg_node:-:A arg_node:-:B add_entity_node:-:nebraska:=:state arg_node:-:B end_operation:-:arg ope_for:-:A return:-:A
how mani state border hawaii ?	add_operation:-:_count add_node:-:B add_type_node:-:_state arg_node:-:B add_node:-:C add_edge:-:_next_to arg_node:-:B arg_node:-:C add_entity_node:-:hawaii:=:state arg_node:-:C end_operation:-:_count ope_for:-:B ope_return:-:A return:-:A
what state is dallas in ?	add_node:-:A add_type_node:-:_state arg_node:-:A add_node:-:B add_edge:-:_loc arg_node:-:B arg_node:-:A add_entity_node:-:dallas:=:city arg_node:-:B return:-:A
what citi has the least popul ?	add_operation:-:_smallest add_node:-:A add_type_node:-:_city arg_node:-:A add_node:-:B add_edge:-:_population arg_node:-:A arg_node:-:B end_operation:-:arg ope_for:-:B return:-:A
how mani peopl stay in utah ?	add_node:-:B add_node:-:A add_edge:-:_population arg_node:-:B arg_node:-:A add_entity_node:-:utah:=:state arg_node:-:B return:-:A
what state has the sparsest popul densiti ?	add_operation:-:_smallest add_node:-:A add_type_node:-:_state arg_node:-:A add_node:-:B add_edge:-:_density arg_node:-:A arg_node:-:B end_operation:-:arg ope_for:-:B return:-:A
what is the largest state that border the state with the lowest point in the usa ?	add_operation:-:_largest add_node:-:A add_type_node:-:_state arg_node:-:A add_node:-:B add_edge:-:_next_to arg_node:-:A arg_node:-:B add_type_node:-:_state arg_node:-:B add_node:-:C add_edge:-:_loc arg_node:-:C arg_node:-:B add_operation:-:_lowest add_type_node:-:_place arg_node:-:C add_node:-:D add_edge:-:_loc arg_node:-:C arg_node:-:D add_entity_node:-:usa:=:country arg_node:-:D end_operation:-:arg ope_for:-:C end_operation:-:arg ope_for:-:A return:-:A
what is the largest citi in texas ?	add_operation:-:_largest add_node:-:A add_type_node:-:_city arg_node:-:A add_node:-:B add_edge:-:_loc arg_node:-:A arg_node:-:B add_entity_node:-:texas:=:state arg_node:-:B end_operation:-:arg ope_for:-:A return:-:A
what is the largest state in the us ?	add_operation:-:_largest add_node:-:A add_type_node:-:_state arg_node:-:A add_node:-:B add_edge:-:_loc arg_node:-:A arg_node:-:B add_entity_node:-:usa:=:country arg_node:-:B end_operation:-:arg ope_for:-:A return:-:A
which state has the most peopl ?	add_operation:-:_largest add_node:-:A add_type_node:-:_state arg_node:-:A add_node:-:B add_edge:-:_population arg_node:-:A arg_node:-:B end_operation:-:arg ope_for:-:B return:-:A
what river are in new mexico ?	add_node:-:A add_type_node:-:_river arg_node:-:A add_node:-:B add_edge:-:_loc arg_node:-:A arg_node:-:B add_entity_node:-:new_mexico:=:state arg_node:-:B return:-:A
what is the area of maryland in squar kilomet ?	add_node:-:B add_node:-:A add_edge:-:_area arg_node:-:B arg_node:-:A add_entity_node:-:maryland:=:state arg_node:-:B return:-:A
how mani state are there in united states ?	add_operation:-:_count add_node:-:B add_type_node:-:_state arg_node:-:B add_node:-:C add_edge:-:_loc arg_node:-:B arg_node:-:C add_entity_node:-:usa:=:country arg_node:-:C end_operation:-:_count ope_for:-:B ope_return:-:A return:-:A
how mani major citi are in state border nebraska ?	add_operation:-:_count add_node:-:B add_type_node:-:_major arg_node:-:B add_type_node:-:_city arg_node:-:B add_node:-:C add_edge:-:_loc arg_node:-:B arg_node:-:C add_type_node:-:_state arg_node:-:C add_node:-:D add_edge:-:_next_to arg_node:-:C arg_node:-:D add_entity_node:-:nebraska:=:state arg_node:-:D end_operation:-:_count ope_for:-:B ope_return:-:A return:-:A
what is the popul of the largest state ?	add_node:-:B add_node:-:A add_edge:-:_population arg_node:-:B arg_node:-:A add_operation:-:_largest add_type_node:-:_state arg_node:-:B end_operation:-:arg ope_for:-:B return:-:A
what is the size of florida ?	add_node:-:B add_node:-:A add_edge:-:_size arg_node:-:B arg_node:-:A add_entity_node:-:florida:=:state arg_node:-:B return:-:A
how mani river are in missouri ?	add_operation:-:_count add_node:-:B add_type_node:-:_river arg_node:-:B add_node:-:C add_edge:-:_loc arg_node:-:B arg_node:-:C add_entity_node:-:missouri:=:state arg_node:-:C end_operation:-:_count ope_for:-:B ope_return:-:A return:-:A
how mani river are there in texas ?	add_operation:-:_count add_node:-:B add_type_node:-:_river arg_node:-:B add_node:-:C add_edge:-:_loc arg_node:-:B arg_node:-:C add_entity_node:-:texas:=:state arg_node:-:C end_operation:-:_count ope_for:-:B ope_return:-:A return:-:A
what is the highest point in the state with the capit des moines ?	add_operation:-:_highest add_node:-:A add_type_node:-:_place arg_node:-:A add_node:-:B add_edge:-:_loc arg_node:-:A arg_node:-:B add_type_node:-:_state arg_node:-:B add_node:-:C add_edge:-:_loc arg_node:-:C arg_node:-:B add_type_node:-:_capital arg_node:-:C add_entity_node:-:des_moines:=:city arg_node:-:C end_operation:-:arg ope_for:-:A return:-:A
what is the popul of seattle ?	add_node:-:B add_node:-:A add_edge:-:_population arg_node:-:B arg_node:-:A add_entity_node:-:seattle:=:city arg_node:-:B return:-:A
what is the highest point in colorado ?	add_operation:-:_highest add_node:-:A add_type_node:-:_place arg_node:-:A add_node:-:B add_edge:-:_loc arg_node:-:A arg_node:-:B add_entity_node:-:colorado:=:state arg_node:-:B end_operation:-:arg ope_for:-:A return:-:A
which state border arizona ?	add_node:-:A add_type_node:-:_state arg_node:-:A add_node:-:B add_edge:-:_next_to arg_node:-:A arg_node:-:B add_entity_node:-:arizona:=:state arg_node:-:B return:-:A
what river run through the state with the lowest point in the usa ?	add_node:-:A add_type_node:-:_river arg_node:-:A add_node:-:B add_edge:-:_traverse arg_node:-:A arg_node:-:B add_type_node:-:_state arg_node:-:B add_node:-:C add_edge:-:_loc arg_node:-:C arg_node:-:B add_operation:-:_lowest add_type_node:-:_place arg_node:-:C add_node:-:D add_edge:-:_loc arg_node:-:C arg_node:-:D add_entity_node:-:usa:=:country arg_node:-:D end_operation:-:arg ope_for:-:C return:-:A
what is the popul of minnesota ?	add_node:-:B add_node:-:A add_edge:-:_population arg_node:-:B arg_node:-:A add_entity_node:-:minnesota:=:state arg_node:-:B return:-:A
what state has the citi with the most popul ?	add_node:-:A add_type_node:-:_state arg_node:-:A add_node:-:B add_edge:-:_loc arg_node:-:B arg_node:-:A add_operation:-:_largest add_type_node:-:_city arg_node:-:B add_node:-:C add_edge:-:_population arg_node:-:B arg_node:-:C end_operation:-:arg ope_for:-:C return:-:A
which state have a major citi name austin ?	add_node:-:A add_type_node:-:_state arg_node:-:A add_node:-:B add_edge:-:_loc arg_node:-:B arg_node:-:A add_type_node:-:_major arg_node:-:B add_type_node:-:_city arg_node:-:B add_entity_node:-:austin:=:city arg_node:-:B return:-:A
which state have point higher than the highest point in colorado ?	add_node:-:A add_type_node:-:_state arg_node:-:A add_node:-:B add_edge:-:_loc arg_node:-:B arg_node:-:A add_type_node:-:_place arg_node:-:B add_node:-:C add_edge:-:_higher arg_node:-:B arg_node:-:C add_operation:-:_highest add_type_node:-:_place arg_node:-:C add_node:-:D add_edge:-:_loc arg_node:-:C arg_node:-:D add_entity_node:-:colorado:=:state arg_node:-:D end_operation:-:arg ope_for:-:C return:-:A
what is the highest point in the state with the smallest popul ?	add_operation:-:_highest add_node:-:A add_type_node:-:_place arg_node:-:A add_node:-:B add_edge:-:_loc arg_node:-:A arg_node:-:B add_operation:-:_smallest add_type_node:-:_state arg_node:-:B add_node:-:C add_edge:-:_population arg_node:-:B arg_node:-:C end_operation:-:arg ope_for:-:C end_operation:-:arg ope_for:-:A return:-:A
where is new hampshire ?	add_node:-:B add_node:-:A add_edge:-:_loc arg_node:-:B arg_node:-:A add_entity_node:-:new_hampshire:=:state arg_node:-:B return:-:A
which state border florida ?	add_node:-:A add_type_node:-:_state arg_node:-:A add_node:-:B add_edge:-:_next_to arg_node:-:A arg_node:-:B add_entity_node:-:florida:=:state arg_node:-:B return:-:A
how mani river in texas are longer than the red ?	add_operation:-:_count add_node:-:B add_type_node:-:_river arg_node:-:B add_node:-:C add_edge:-:_loc arg_node:-:B arg_node:-:C add_entity_node:-:texas:=:state arg_node:-:C add_node:-:D add_edge:-:_longer arg_node:-:B arg_node:-:D add_entity_node:-:red:=:river arg_node:-:D end_operation:-:_count ope_for:-:B ope_return:-:A return:-:A
how mani river do not travers the state with the capit albany ?	add_operation:-:_count add_node:-:B add_type_node:-:_river arg_node:-:B add_operation:-:_not add_node:-:C add_edge:-:_traverse arg_node:-:B arg_node:-:C add_type_node:-:_state arg_node:-:C add_node:-:D add_edge:-:_loc arg_node:-:D arg_node:-:C add_type_node:-:_capital arg_node:-:D add_entity_node:-:albany:=:city arg_node:-:D end_operation:-:_not end_operation:-:_count ope_for:-:B ope_return:-:A return:-:A
what are the popul of the state through which the mississippi run ?	add_node:-:B add_node:-:A add_edge:-:_population arg_node:-:B arg_node:-:A add_type_node:-:_state arg_node:-:B add_node:-:C add_edge:-:_traverse arg_node:-:C arg_node:-:B add_entity_node:-:mississippi:=:river arg_node:-:C return:-:A
through which state doe the mississippi run ?	add_node:-:A add_type_node:-:_state arg_node:-:A add_node:-:B add_edge:-:_traverse arg_node:-:B arg_node:-:A add_entity_node:-:mississippi:=:river arg_node:-:B return:-:A
what state are next to the mississippi ?	add_node:-:A add_type_node:-:_state arg_node:-:A add_node:-:B add_edge:-:_next_to arg_node:-:A arg_node:-:B add_entity_node:-:mississippi:=:state arg_node:-:B return:-:A
give me the citi in virginia ?	add_node:-:A add_type_node:-:_city arg_node:-:A add_node:-:B add_edge:-:_loc arg_node:-:A arg_node:-:B add_entity_node:-:virginia:=:state arg_node:-:B return:-:A
what are the capit citi of the state which border texas ?	add_node:-:A add_type_node:-:_capital arg_node:-:A add_type_node:-:_city arg_node:-:A add_node:-:B add_edge:-:_loc arg_node:-:A arg_node:-:B add_type_node:-:_state arg_node:-:B add_node:-:C add_edge:-:_next_to arg_node:-:B arg_node:-:C add_entity_node:-:texas:=:state arg_node:-:C return:-:A
what state that border texas has the highest popul ?	add_operation:-:_largest add_node:-:A add_type_node:-:_state arg_node:-:A add_node:-:C add_edge:-:_next_to arg_node:-:A arg_node:-:C add_entity_node:-:texas:=:state arg_node:-:C add_node:-:B add_edge:-:_population arg_node:-:A arg_node:-:B end_operation:-:arg ope_for:-:B return:-:A
what state is the state with the most river ?	add_node:-:A add_type_node:-:_state arg_node:-:A add_operation:-:_most add_type_node:-:_state arg_node:-:A add_node:-:B add_edge:-:_loc arg_node:-:B arg_node:-:A add_type_node:-:_river arg_node:-:B end_operation:-:arg_count ope_for:-:A ope_for:-:B return:-:A
what state has the least popul densiti ?	add_operation:-:_smallest add_node:-:A add_type_node:-:_state arg_node:-:A add_node:-:B add_edge:-:_density arg_node:-:A arg_node:-:B end_operation:-:arg ope_for:-:B return:-:A
what are the major citi in ohio ?	add_node:-:A add_type_node:-:_major arg_node:-:A add_type_node:-:_city arg_node:-:A add_node:-:B add_edge:-:_loc arg_node:-:A arg_node:-:B add_entity_node:-:ohio:=:state arg_node:-:B return:-:A
which state doe the missouri river run through ?	add_node:-:A add_type_node:-:_state arg_node:-:A add_node:-:B add_edge:-:_traverse arg_node:-:B arg_node:-:A add_entity_node:-:missouri:=:river arg_node:-:B add_type_node:-:_river arg_node:-:B return:-:A
what is the biggest citi in arizona ?	add_operation:-:_largest add_node:-:A add_type_node:-:_city arg_node:-:A add_node:-:B add_edge:-:_loc arg_node:-:A arg_node:-:B add_entity_node:-:arizona:=:state arg_node:-:B end_operation:-:arg ope_for:-:A return:-:A
how mani peopl live in hawaii ?	add_node:-:B add_node:-:A add_edge:-:_population arg_node:-:B arg_node:-:A add_entity_node:-:hawaii:=:state arg_node:-:B return:-:A
how mani peopl live in the smallest state border wyoming ?	add_node:-:B add_node:-:A add_edge:-:_population arg_node:-:B arg_node:-:A add_operation:-:_smallest add_type_node:-:_state arg_node:-:B add_node:-:C add_edge:-:_next_to arg_node:-:B arg_node:-:C add_entity_node:-:wyoming:=:state arg_node:-:C end_operation:-:arg ope_for:-:B return:-:A
what is the name of the state with the lowest point ?	add_node:-:A add_type_node:-:_state arg_node:-:A add_node:-:B add_edge:-:_loc arg_node:-:B arg_node:-:A add_operation:-:_lowest add_type_node:-:_place arg_node:-:B end_operation:-:arg ope_for:-:B return:-:A
what river flow through missouri ?	add_node:-:A add_type_node:-:_river arg_node:-:A add_node:-:B add_edge:-:_traverse arg_node:-:A arg_node:-:B add_entity_node:-:missouri:=:state arg_node:-:B return:-:A
what is the elev of death valley ?	add_node:-:B add_node:-:A add_edge:-:_elevation arg_node:-:B arg_node:-:A add_entity_node:-:death_valley:=:place arg_node:-:B return:-:A
what river flow through texas ?	add_node:-:A add_type_node:-:_river arg_node:-:A add_node:-:B add_edge:-:_traverse arg_node:-:A arg_node:-:B add_entity_node:-:texas:=:state arg_node:-:B return:-:A
how high are the highest point of all the state ?	add_node:-:B add_node:-:A add_edge:-:_elevation arg_node:-:B arg_node:-:A add_operation:-:_highest add_type_node:-:_place arg_node:-:B add_node:-:C add_edge:-:_loc arg_node:-:B arg_node:-:C add_type_node:-:_state arg_node:-:C end_operation:-:arg ope_for:-:B return:-:A
what is the capit of new hampshire ?	add_node:-:A add_type_node:-:_capital arg_node:-:A add_node:-:B add_edge:-:_loc arg_node:-:A arg_node:-:B add_entity_node:-:new_hampshire:=:state arg_node:-:B return:-:A
how long is the rio grande river ?	add_node:-:B add_node:-:A add_edge:-:_len arg_node:-:B arg_node:-:A add_entity_node:-:rio_grande:=:river arg_node:-:B add_type_node:-:_river arg_node:-:B return:-:A
which state border most state ?	add_operation:-:_most add_node:-:A add_type_node:-:_state arg_node:-:A add_node:-:B add_edge:-:_next_to arg_node:-:A arg_node:-:B add_type_node:-:_state arg_node:-:B end_operation:-:arg_count ope_for:-:A ope_for:-:B return:-:A
how mani state doe missouri border ?	add_operation:-:_count add_node:-:B add_type_node:-:_state arg_node:-:B add_node:-:C add_edge:-:_next_to arg_node:-:C arg_node:-:B add_entity_node:-:missouri:=:state arg_node:-:C end_operation:-:_count ope_for:-:B ope_return:-:A return:-:A
where is austin ?	add_node:-:B add_node:-:A add_edge:-:_loc arg_node:-:B arg_node:-:A add_entity_node:-:austin:=:city arg_node:-:B return:-:A
how high is the highest point of delaware ?	add_node:-:B add_node:-:A add_edge:-:_elevation arg_node:-:B arg_node:-:A add_operation:-:_highest add_type_node:-:_place arg_node:-:B add_node:-:C add_edge:-:_loc arg_node:-:B arg_node:-:C add_entity_node:-:delaware:=:state arg_node:-:C end_operation:-:arg ope_for:-:B return:-:A
where is the highest point in montana ?	add_operation:-:_highest add_node:-:A add_type_node:-:_place arg_node:-:A add_node:-:B add_edge:-:_loc arg_node:-:A arg_node:-:B add_entity_node:-:montana:=:state arg_node:-:B end_operation:-:arg ope_for:-:A return:-:A
what state border state that border the state with the largest popul ?	add_node:-:A add_type_node:-:_state arg_node:-:A add_node:-:B add_edge:-:_next_to arg_node:-:A arg_node:-:B add_type_node:-:_state arg_node:-:B add_node:-:C add_edge:-:_next_to arg_node:-:B arg_node:-:C add_operation:-:_largest add_type_node:-:_state arg_node:-:C add_node:-:D add_edge:-:_population arg_node:-:C arg_node:-:D end_operation:-:arg ope_for:-:D return:-:A
what is the height of the highest mountain in texas ?	add_node:-:B add_node:-:A add_edge:-:_elevation arg_node:-:B arg_node:-:A add_operation:-:_highest add_type_node:-:_mountain arg_node:-:B add_node:-:C add_edge:-:_loc arg_node:-:B arg_node:-:C add_entity_node:-:texas:=:state arg_node:-:C end_operation:-:arg ope_for:-:B return:-:A
what state has the citi flint ?	add_node:-:A add_type_node:-:_state arg_node:-:A add_node:-:B add_edge:-:_loc arg_node:-:B arg_node:-:A add_type_node:-:_city arg_node:-:B add_entity_node:-:flint:=:city arg_node:-:B return:-:A
what is the state with the largest densiti in usa ?	add_operation:-:_largest add_node:-:A add_type_node:-:_state arg_node:-:A add_node:-:B add_edge:-:_density arg_node:-:A arg_node:-:B add_node:-:C add_edge:-:_loc arg_node:-:A arg_node:-:C add_entity_node:-:usa:=:country arg_node:-:C end_operation:-:arg ope_for:-:B return:-:A
what citi in texas have the highest number of citizen ?	add_operation:-:_largest add_node:-:A add_type_node:-:_city arg_node:-:A add_node:-:C add_edge:-:_loc arg_node:-:A arg_node:-:C add_entity_node:-:texas:=:state arg_node:-:C add_node:-:B add_edge:-:_population arg_node:-:A arg_node:-:B end_operation:-:arg ope_for:-:B return:-:A
what state border missouri ?	add_node:-:A add_type_node:-:_state arg_node:-:A add_node:-:B add_edge:-:_next_to arg_node:-:A arg_node:-:B add_entity_node:-:missouri:=:state arg_node:-:B return:-:A
give me the largest state ?	add_operation:-:_largest add_node:-:A add_type_node:-:_state arg_node:-:A end_operation:-:arg ope_for:-:A return:-:A
which state has the sparsest popul densiti ?	add_operation:-:_smallest add_node:-:A add_type_node:-:_state arg_node:-:A add_node:-:B add_edge:-:_density arg_node:-:A arg_node:-:B end_operation:-:arg ope_for:-:B return:-:A
which state border alabama ?	add_node:-:A add_type_node:-:_state arg_node:-:A add_node:-:B add_edge:-:_next_to arg_node:-:A arg_node:-:B add_entity_node:-:alabama:=:state arg_node:-:B return:-:A
what river flow through state that alabama border ?	add_node:-:A add_type_node:-:_river arg_node:-:A add_node:-:B add_edge:-:_traverse arg_node:-:A arg_node:-:B add_type_node:-:_state arg_node:-:B add_node:-:C add_edge:-:_next_to arg_node:-:C arg_node:-:B add_entity_node:-:alabama:=:state arg_node:-:C return:-:A
what are the major citi in wyoming ?	add_node:-:A add_type_node:-:_major arg_node:-:A add_type_node:-:_city arg_node:-:A add_node:-:B add_edge:-:_loc arg_node:-:A arg_node:-:B add_entity_node:-:wyoming:=:state arg_node:-:B return:-:A
what are the highest point of state surround mississippi ?	add_operation:-:_highest add_node:-:A add_type_node:-:_place arg_node:-:A add_node:-:B add_edge:-:_loc arg_node:-:A arg_node:-:B add_type_node:-:_state arg_node:-:B add_node:-:C add_edge:-:_next_to arg_node:-:B arg_node:-:C add_entity_node:-:mississippi:=:state arg_node:-:C end_operation:-:arg ope_for:-:A return:-:A
through which state doe the mississippi flow ?	add_node:-:A add_type_node:-:_state arg_node:-:A add_node:-:B add_edge:-:_traverse arg_node:-:B arg_node:-:A add_entity_node:-:mississippi:=:river arg_node:-:B return:-:A
where is scotts valley ?	add_node:-:B add_node:-:A add_edge:-:_loc arg_node:-:B arg_node:-:A add_entity_node:-:scotts_valley:=:city arg_node:-:B return:-:A
what are the major lake in united states ?	add_node:-:A add_type_node:-:_major arg_node:-:A add_type_node:-:_lake arg_node:-:A add_node:-:B add_edge:-:_loc arg_node:-:A arg_node:-:B add_entity_node:-:usa:=:country arg_node:-:B return:-:A
what is the largest citi in missouri ?	add_operation:-:_largest add_node:-:A add_type_node:-:_city arg_node:-:A add_node:-:B add_edge:-:_loc arg_node:-:A arg_node:-:B add_entity_node:-:missouri:=:state arg_node:-:B end_operation:-:arg ope_for:-:A return:-:A
what state border alaska ?	add_node:-:A add_type_node:-:_state arg_node:-:A add_node:-:B add_edge:-:_next_to arg_node:-:A arg_node:-:B add_entity_node:-:alaska:=:state arg_node:-:B return:-:A
what state has the largest citi ?	add_operation:-:_largest add_node:-:A add_type_node:-:_state arg_node:-:A add_node:-:B add_edge:-:_loc arg_node:-:B arg_node:-:A add_type_node:-:_city arg_node:-:B end_operation:-:arg ope_for:-:B return:-:A
what river run through maine ?	add_node:-:A add_type_node:-:_river arg_node:-:A add_node:-:B add_edge:-:_traverse arg_node:-:A arg_node:-:B add_entity_node:-:maine:=:state arg_node:-:B return:-:A
give me the lake in california ?	add_node:-:A add_type_node:-:_lake arg_node:-:A add_node:-:B add_edge:-:_loc arg_node:-:A arg_node:-:B add_entity_node:-:california:=:state arg_node:-:B return:-:A
what is the combin popul of all 50 state ?	add_operation:-:_sum add_node:-:C add_type_node:-:_state arg_node:-:C add_type_node:-:_population arg_node:-:C end_operation:-:_sum ope_for:-:C ope_in:-:_population ope_return:-:A return:-:A
how high is the highest point of louisiana ?	add_node:-:B add_node:-:A add_edge:-:_elevation arg_node:-:B arg_node:-:A add_operation:-:_highest add_type_node:-:_place arg_node:-:B add_node:-:C add_edge:-:_loc arg_node:-:B arg_node:-:C add_entity_node:-:louisiana:=:state arg_node:-:C end_operation:-:arg ope_for:-:B return:-:A
what is the longest river in pennsylvania ?	add_operation:-:_longest add_node:-:A add_type_node:-:_river arg_node:-:A add_node:-:B add_edge:-:_loc arg_node:-:A arg_node:-:B add_entity_node:-:pennsylvania:=:state arg_node:-:B end_operation:-:arg ope_for:-:A return:-:A
what is the capit of maryland ?	add_node:-:A add_type_node:-:_capital arg_node:-:A add_node:-:B add_edge:-:_loc arg_node:-:A arg_node:-:B add_entity_node:-:maryland:=:state arg_node:-:B return:-:A
what state is the biggest ?	add_operation:-:_largest add_node:-:A add_type_node:-:_state arg_node:-:A end_operation:-:arg ope_for:-:A return:-:A
which state border iowa ?	add_node:-:A add_type_node:-:_state arg_node:-:A add_node:-:B add_edge:-:_next_to arg_node:-:A arg_node:-:B add_entity_node:-:iowa:=:state arg_node:-:B return:-:A
which state border alaska ?	add_node:-:A add_type_node:-:_state arg_node:-:A add_node:-:B add_edge:-:_next_to arg_node:-:A arg_node:-:B add_entity_node:-:alaska:=:state arg_node:-:B return:-:A
what is the largest state in usa ?	add_operation:-:_largest add_node:-:A add_type_node:-:_state arg_node:-:A add_node:-:B add_edge:-:_loc arg_node:-:A arg_node:-:B add_entity_node:-:usa:=:country arg_node:-:B end_operation:-:arg ope_for:-:A return:-:A
what are the major citi in california ?	add_node:-:A add_type_node:-:_major arg_node:-:A add_type_node:-:_city arg_node:-:A add_node:-:B add_edge:-:_loc arg_node:-:A arg_node:-:B add_entity_node:-:california:=:state arg_node:-:B return:-:A
what is the largest state travers by the mississippi river ?	add_operation:-:_largest add_node:-:A add_type_node:-:_state arg_node:-:A add_node:-:B add_edge:-:_traverse arg_node:-:B arg_node:-:A add_entity_node:-:mississippi:=:river arg_node:-:B end_operation:-:arg ope_for:-:A return:-:A
which river run through state border new mexico ?	add_node:-:A add_type_node:-:_river arg_node:-:A add_node:-:B add_edge:-:_traverse arg_node:-:A arg_node:-:B add_type_node:-:_state arg_node:-:B add_node:-:C add_edge:-:_next_to arg_node:-:B arg_node:-:C add_entity_node:-:new_mexico:=:state arg_node:-:C return:-:A
what is the lowest point in the state of texas ?	add_operation:-:_lowest add_node:-:A add_type_node:-:_place arg_node:-:A add_node:-:B add_edge:-:_loc arg_node:-:A arg_node:-:B add_type_node:-:_state arg_node:-:B add_entity_node:-:texas:=:state arg_node:-:B end_operation:-:arg ope_for:-:A return:-:A
what is the smallest state border ohio ?	add_operation:-:_smallest add_node:-:A add_type_node:-:_state arg_node:-:A add_node:-:B add_edge:-:_next_to arg_node:-:A arg_node:-:B add_entity_node:-:ohio:=:state arg_node:-:B end_operation:-:arg ope_for:-:A return:-:A
how mani state are next to major river ?	add_operation:-:_count add_node:-:B add_type_node:-:_state arg_node:-:B add_node:-:C add_edge:-:_next_to arg_node:-:B arg_node:-:C add_type_node:-:_major arg_node:-:C add_type_node:-:_river arg_node:-:C end_operation:-:_count ope_for:-:B ope_return:-:A return:-:A
what is the lowest point of the us ?	add_operation:-:_lowest add_node:-:A add_type_node:-:_place arg_node:-:A add_node:-:B add_edge:-:_loc arg_node:-:A arg_node:-:B add_entity_node:-:usa:=:country arg_node:-:B end_operation:-:arg ope_for:-:A return:-:A
which state has the greatest densiti ?	add_operation:-:_largest add_node:-:A add_type_node:-:_state arg_node:-:A add_node:-:B add_edge:-:_density arg_node:-:A arg_node:-:B end_operation:-:arg ope_for:-:B return:-:A
how mani state border the largest state ?	add_operation:-:_count add_node:-:B add_type_node:-:_state arg_node:-:B add_node:-:C add_edge:-:_next_to arg_node:-:B arg_node:-:C add_operation:-:_largest add_type_node:-:_state arg_node:-:C end_operation:-:arg ope_for:-:C end_operation:-:_count ope_for:-:B ope_return:-:A return:-:A
what is the longest river that doe not run through texas ?	add_operation:-:_longest add_node:-:A add_type_node:-:_river arg_node:-:A add_operation:-:_not add_node:-:B add_edge:-:_traverse arg_node:-:A arg_node:-:B add_entity_node:-:texas:=:state arg_node:-:B end_operation:-:_not end_operation:-:arg ope_for:-:A return:-:A
give me all the state of usa ?	add_node:-:A add_type_node:-:_state arg_node:-:A add_node:-:B add_edge:-:_loc arg_node:-:A arg_node:-:B add_entity_node:-:usa:=:country arg_node:-:B return:-:A
what is the densiti of texas ?	add_node:-:B add_node:-:A add_edge:-:_density arg_node:-:B arg_node:-:A add_entity_node:-:texas:=:state arg_node:-:B return:-:A
what is the smallest citi of the smallest state in the us ?	add_operation:-:_smallest add_node:-:A add_type_node:-:_city arg_node:-:A add_node:-:B add_edge:-:_loc arg_node:-:A arg_node:-:B add_operation:-:_smallest add_type_node:-:_state arg_node:-:B add_node:-:C add_edge:-:_loc arg_node:-:B arg_node:-:C add_entity_node:-:usa:=:country arg_node:-:C end_operation:-:arg ope_for:-:B end_operation:-:arg ope_for:-:A return:-:A
what is the highest point in kansas ?	add_operation:-:_highest add_node:-:A add_type_node:-:_place arg_node:-:A add_node:-:B add_edge:-:_loc arg_node:-:A arg_node:-:B add_entity_node:-:kansas:=:state arg_node:-:B end_operation:-:arg ope_for:-:A return:-:A
what is the popul in boston ?	add_node:-:B add_node:-:A add_edge:-:_population arg_node:-:B arg_node:-:A add_entity_node:-:boston:=:city arg_node:-:B return:-:A
how mani peopl are in the state of nevada ?	add_node:-:B add_node:-:A add_edge:-:_population arg_node:-:B arg_node:-:A add_entity_node:-:nevada:=:state arg_node:-:B return:-:A
what is the popul densiti of texas ?	add_node:-:B add_node:-:A add_edge:-:_density arg_node:-:B arg_node:-:A add_entity_node:-:texas:=:state arg_node:-:B return:-:A
how mani peopl live in washington dc ?	add_node:-:B add_node:-:A add_edge:-:_population arg_node:-:B arg_node:-:A add_entity_node:-:washington_dc:=:city arg_node:-:B return:-:A
give me the citi in texas ?	add_node:-:A add_type_node:-:_city arg_node:-:A add_node:-:B add_edge:-:_loc arg_node:-:A arg_node:-:B add_entity_node:-:texas:=:state arg_node:-:B return:-:A
how long is the shortest river in the usa ?	add_node:-:B add_node:-:A add_edge:-:_len arg_node:-:B arg_node:-:A add_operation:-:_shortest add_type_node:-:_river arg_node:-:B add_node:-:C add_edge:-:_loc arg_node:-:B arg_node:-:C add_entity_node:-:usa:=:country arg_node:-:C end_operation:-:arg ope_for:-:B return:-:A
how mani state have major river ?	add_operation:-:_count add_node:-:B add_type_node:-:_state arg_node:-:B add_node:-:C add_edge:-:_loc arg_node:-:C arg_node:-:B add_type_node:-:_major arg_node:-:C add_type_node:-:_river arg_node:-:C end_operation:-:_count ope_for:-:B ope_return:-:A return:-:A
what is the popul densiti of the smallest state ?	add_node:-:B add_node:-:A add_edge:-:_density arg_node:-:B arg_node:-:A add_operation:-:_smallest add_type_node:-:_state arg_node:-:B end_operation:-:arg ope_for:-:B return:-:A
which state border michigan ?	add_node:-:A add_type_node:-:_state arg_node:-:A add_node:-:B add_edge:-:_next_to arg_node:-:A arg_node:-:B add_entity_node:-:michigan:=:state arg_node:-:B return:-:A
what citi in texas have the highest popul ?	add_operation:-:_largest add_node:-:A add_type_node:-:_city arg_node:-:A add_node:-:C add_edge:-:_loc arg_node:-:A arg_node:-:C add_entity_node:-:texas:=:state arg_node:-:C add_node:-:B add_edge:-:_population arg_node:-:A arg_node:-:B end_operation:-:arg ope_for:-:B return:-:A
what river run through the state that border the state with the capit atlanta ?	add_node:-:A add_type_node:-:_river arg_node:-:A add_node:-:B add_edge:-:_traverse arg_node:-:A arg_node:-:B add_type_node:-:_state arg_node:-:B add_node:-:C add_edge:-:_next_to arg_node:-:B arg_node:-:C add_type_node:-:_state arg_node:-:C add_node:-:D add_edge:-:_loc arg_node:-:D arg_node:-:C add_type_node:-:_capital arg_node:-:D add_entity_node:-:atlanta:=:city arg_node:-:D return:-:A
what is the highest point in the country ?	add_operation:-:_highest add_node:-:A add_type_node:-:_place arg_node:-:A add_node:-:B add_edge:-:_loc arg_node:-:A arg_node:-:B add_entity_node:-:usa:=:country arg_node:-:B end_operation:-:arg ope_for:-:A return:-:A
how mani peopl live in kalamazoo ?	add_node:-:B add_node:-:A add_edge:-:_population arg_node:-:B arg_node:-:A add_entity_node:-:kalamazoo:=:city arg_node:-:B return:-:A
how mani major citi are in florida ?	add_operation:-:_count add_node:-:B add_type_node:-:_major arg_node:-:B add_type_node:-:_city arg_node:-:B add_node:-:C add_edge:-:_loc arg_node:-:B arg_node:-:C add_entity_node:-:florida:=:state arg_node:-:C end_operation:-:_count ope_for:-:B ope_return:-:A return:-:A
what state has the greatest popul densiti ?	add_operation:-:_largest add_node:-:A add_type_node:-:_state arg_node:-:A add_node:-:B add_edge:-:_density arg_node:-:A arg_node:-:B end_operation:-:arg ope_for:-:B return:-:A
how mani river are found in colorado ?	add_operation:-:_count add_node:-:B add_type_node:-:_river arg_node:-:B add_node:-:C add_edge:-:_loc arg_node:-:B arg_node:-:C add_entity_node:-:colorado:=:state arg_node:-:C end_operation:-:_count ope_for:-:B ope_return:-:A return:-:A
what is the lowest point of the state with the largest area ?	add_operation:-:_lowest add_node:-:A add_type_node:-:_place arg_node:-:A add_node:-:B add_edge:-:_loc arg_node:-:A arg_node:-:B add_operation:-:_largest add_type_node:-:_state arg_node:-:B add_node:-:C add_edge:-:_area arg_node:-:B arg_node:-:C end_operation:-:arg ope_for:-:C end_operation:-:arg ope_for:-:A return:-:A
