what is the highest point in florida ?	add_operation:-:_highest add_node:-:A add_type_node:-:_place arg_node:-:A add_node:-:B add_edge:-:_loc arg_node:-:A arg_node:-:B add_entity_node:-:florida:=:state arg_node:-:B end_operation:-:arg ope_for:-:A return:-:A
what are the high points of states surrounding mississippi ?	add_node:-:B add_node:-:A add_edge:-:_high_point arg_node:-:B arg_node:-:A add_edge:-:_loc arg_node:-:A arg_node:-:B add_type_node:-:_state arg_node:-:B add_node:-:C add_edge:-:_next_to arg_node:-:B arg_node:-:C add_entity_node:-:mississippi:=:state arg_node:-:C return:-:A
what state has the shortest river ?	add_node:-:A add_type_node:-:_state arg_node:-:A add_node:-:B add_edge:-:_loc arg_node:-:B arg_node:-:A add_operation:-:_shortest add_type_node:-:_river arg_node:-:B end_operation:-:arg ope_for:-:B return:-:A
what is the tallest mountain in the united states ?	add_operation:-:_highest add_node:-:A add_type_node:-:_mountain arg_node:-:A add_node:-:B add_edge:-:_loc arg_node:-:A arg_node:-:B add_entity_node:-:usa:=:country arg_node:-:B end_operation:-:arg ope_for:-:A return:-:A
what is the capital of maine ?	add_node:-:A add_type_node:-:_capital arg_node:-:A add_node:-:B add_edge:-:_loc arg_node:-:A arg_node:-:B add_entity_node:-:maine:=:state arg_node:-:B return:-:A
what are the populations of states through which the mississippi river run ?	add_node:-:B add_node:-:A add_edge:-:_population arg_node:-:B arg_node:-:A add_type_node:-:_state arg_node:-:B add_node:-:C add_edge:-:_traverse arg_node:-:C arg_node:-:B add_entity_node:-:mississippi:=:river arg_node:-:C add_type_node:-:_river arg_node:-:C return:-:A
name all the lakes of us ?	add_node:-:A add_type_node:-:_lake arg_node:-:A add_node:-:B add_edge:-:_loc arg_node:-:A arg_node:-:B add_entity_node:-:usa:=:country arg_node:-:B return:-:A
which states border states through which the mississippi traverses ?	add_node:-:A add_type_node:-:_state arg_node:-:A add_node:-:B add_edge:-:_next_to arg_node:-:A arg_node:-:B add_type_node:-:_state arg_node:-:B add_node:-:C add_edge:-:_traverse arg_node:-:C arg_node:-:B add_entity_node:-:mississippi:=:river arg_node:-:C return:-:A
what is the highest mountain in alaska ?	add_operation:-:_highest add_node:-:A add_type_node:-:_mountain arg_node:-:A add_node:-:B add_edge:-:_loc arg_node:-:A arg_node:-:B add_entity_node:-:alaska:=:state arg_node:-:B end_operation:-:arg ope_for:-:A return:-:A
what is the population of illinois ?	add_node:-:B add_node:-:A add_edge:-:_population arg_node:-:B arg_node:-:A add_entity_node:-:illinois:=:state arg_node:-:B return:-:A
name all the rivers in colorado ?	add_node:-:A add_type_node:-:_river arg_node:-:A add_node:-:B add_edge:-:_loc arg_node:-:A arg_node:-:B add_entity_node:-:colorado:=:state arg_node:-:B return:-:A
in which state does the highest point in usa exist ?	add_node:-:B add_node:-:A add_edge:-:_loc arg_node:-:B arg_node:-:A add_type_node:-:_state arg_node:-:A add_operation:-:_highest add_type_node:-:_place arg_node:-:B add_node:-:C add_edge:-:_loc arg_node:-:B arg_node:-:C add_entity_node:-:usa:=:country arg_node:-:C end_operation:-:arg ope_for:-:B return:-:A
which state is the city denver located in ?	add_node:-:A add_type_node:-:_state arg_node:-:A add_node:-:B add_edge:-:_loc arg_node:-:B arg_node:-:A add_type_node:-:_city arg_node:-:B add_entity_node:-:denver:=:city arg_node:-:B return:-:A
what is the lowest point in texas ?	add_operation:-:_lowest add_node:-:A add_type_node:-:_place arg_node:-:A add_node:-:B add_edge:-:_loc arg_node:-:A arg_node:-:B add_entity_node:-:texas:=:state arg_node:-:B end_operation:-:arg ope_for:-:A return:-:A
how many states have a city called rochester ?	add_operation:-:_count add_node:-:B add_type_node:-:_state arg_node:-:B add_node:-:C add_edge:-:_loc arg_node:-:C arg_node:-:B add_entity_node:-:rochester:=:city arg_node:-:C end_operation:-:_count ope_for:-:B ope_return:-:A return:-:A
which capitals are in the states that border texas ?	add_node:-:A add_type_node:-:_capital arg_node:-:A add_node:-:B add_edge:-:_loc arg_node:-:A arg_node:-:B add_type_node:-:_state arg_node:-:B add_node:-:C add_edge:-:_next_to arg_node:-:B arg_node:-:C add_entity_node:-:texas:=:state arg_node:-:C return:-:A
how many people live in austin ?	add_node:-:B add_node:-:A add_edge:-:_population arg_node:-:B arg_node:-:A add_entity_node:-:austin:=:city arg_node:-:B return:-:A
what states have rivers named colorado ?	add_node:-:A add_type_node:-:_state arg_node:-:A add_node:-:B add_edge:-:_loc arg_node:-:B arg_node:-:A add_entity_node:-:colorado:=:river arg_node:-:B return:-:A
what is the size of texas ?	add_node:-:B add_node:-:A add_edge:-:_size arg_node:-:B arg_node:-:A add_entity_node:-:texas:=:state arg_node:-:B return:-:A
what is the shortest river in the usa ?	add_operation:-:_shortest add_node:-:A add_type_node:-:_river arg_node:-:A add_node:-:B add_edge:-:_loc arg_node:-:A arg_node:-:B add_entity_node:-:usa:=:country arg_node:-:B end_operation:-:arg ope_for:-:A return:-:A
what are the major cities of the us ?	add_node:-:A add_type_node:-:_major arg_node:-:A add_type_node:-:_city arg_node:-:A add_node:-:B add_edge:-:_loc arg_node:-:A arg_node:-:B add_entity_node:-:usa:=:country arg_node:-:B return:-:A
which state border kentucky ?	add_node:-:A add_type_node:-:_state arg_node:-:A add_node:-:B add_edge:-:_next_to arg_node:-:A arg_node:-:B add_entity_node:-:kentucky:=:state arg_node:-:B return:-:A
what is the population of oregon ?	add_node:-:B add_node:-:A add_edge:-:_population arg_node:-:B arg_node:-:A add_entity_node:-:oregon:=:state arg_node:-:B return:-:A
what states have a city named austin ?	add_node:-:A add_type_node:-:_state arg_node:-:A add_node:-:B add_edge:-:_loc arg_node:-:B arg_node:-:A add_entity_node:-:austin:=:city arg_node:-:B return:-:A
what is the highest elevation in south carolina ?	add_operation:-:_highest add_node:-:A add_type_node:-:_place arg_node:-:A add_node:-:B add_edge:-:_loc arg_node:-:A arg_node:-:B add_entity_node:-:south_carolina:=:state arg_node:-:B end_operation:-:arg ope_for:-:A return:-:A
how many people live in austin texas ?	add_node:-:B add_node:-:A add_edge:-:_population arg_node:-:B arg_node:-:A add_entity_node:-:austin_tx:=:city arg_node:-:B return:-:A
what are the rivers in the state of texas ?	add_node:-:A add_type_node:-:_river arg_node:-:A add_node:-:B add_edge:-:_loc arg_node:-:A arg_node:-:B add_type_node:-:_state arg_node:-:B add_entity_node:-:texas:=:state arg_node:-:B return:-:A
what is the lowest point of colorado ?	add_operation:-:_lowest add_node:-:A add_type_node:-:_place arg_node:-:A add_node:-:B add_edge:-:_loc arg_node:-:A arg_node:-:B add_entity_node:-:colorado:=:state arg_node:-:B end_operation:-:arg ope_for:-:A return:-:A
what is the population of atlanta ?	add_node:-:B add_node:-:A add_edge:-:_population arg_node:-:B arg_node:-:A add_entity_node:-:atlanta:=:city arg_node:-:B return:-:A
what rivers are in utah ?	add_node:-:A add_type_node:-:_river arg_node:-:A add_node:-:B add_edge:-:_loc arg_node:-:A arg_node:-:B add_entity_node:-:utah:=:state arg_node:-:B return:-:A
what river runs through the most states ?	add_operation:-:_most add_node:-:A add_type_node:-:_river arg_node:-:A add_node:-:B add_edge:-:_traverse arg_node:-:A arg_node:-:B add_type_node:-:_state arg_node:-:B end_operation:-:arg_count ope_for:-:A ope_for:-:B return:-:A
what is the population of sacramento ?	add_node:-:B add_node:-:A add_edge:-:_population arg_node:-:B arg_node:-:A add_entity_node:-:sacramento:=:city arg_node:-:B return:-:A
could you tell me what is the highest point in the state of oregon ?	add_operation:-:_highest add_node:-:A add_type_node:-:_place arg_node:-:A add_node:-:B add_edge:-:_loc arg_node:-:A arg_node:-:B add_type_node:-:_state arg_node:-:B add_entity_node:-:oregon:=:state arg_node:-:B end_operation:-:arg ope_for:-:A return:-:A
which states does the mississippi river run through ?	add_node:-:A add_type_node:-:_state arg_node:-:A add_node:-:B add_edge:-:_traverse arg_node:-:B arg_node:-:A add_entity_node:-:mississippi:=:river arg_node:-:B add_type_node:-:_river arg_node:-:B return:-:A
what are the major cities in the smallest state in the us ?	add_node:-:A add_type_node:-:_major arg_node:-:A add_type_node:-:_city arg_node:-:A add_node:-:B add_edge:-:_loc arg_node:-:A arg_node:-:B add_operation:-:_smallest add_type_node:-:_state arg_node:-:B add_node:-:C add_edge:-:_loc arg_node:-:B arg_node:-:C add_entity_node:-:usa:=:country arg_node:-:C end_operation:-:arg ope_for:-:B return:-:A
how high is guadalupe peak ?	add_node:-:B add_node:-:A add_edge:-:_elevation arg_node:-:B arg_node:-:A add_entity_node:-:guadalupe_peak:=:place arg_node:-:B return:-:A
what river runs through illinois ?	add_node:-:A add_type_node:-:_river arg_node:-:A add_node:-:B add_edge:-:_traverse arg_node:-:A arg_node:-:B add_entity_node:-:illinois:=:state arg_node:-:B return:-:A
how long is the mississippi river ?	add_node:-:B add_node:-:A add_edge:-:_len arg_node:-:B arg_node:-:A add_entity_node:-:mississippi:=:river arg_node:-:B add_type_node:-:_river arg_node:-:B return:-:A
how high is the highest point in the largest state ?	add_node:-:B add_node:-:A add_edge:-:_elevation arg_node:-:B arg_node:-:A add_operation:-:_highest add_type_node:-:_place arg_node:-:B add_node:-:C add_edge:-:_loc arg_node:-:B arg_node:-:C add_operation:-:_largest add_type_node:-:_state arg_node:-:C end_operation:-:arg ope_for:-:C end_operation:-:arg ope_for:-:B return:-:A
what is the area of south carolina ?	add_node:-:B add_node:-:A add_edge:-:_area arg_node:-:B arg_node:-:A add_entity_node:-:south_carolina:=:state arg_node:-:B return:-:A
what are the states through which the longest river runs ?	add_node:-:A add_type_node:-:_state arg_node:-:A add_operation:-:_longest add_node:-:B add_edge:-:_traverse arg_node:-:B arg_node:-:A add_type_node:-:_river arg_node:-:B end_operation:-:arg ope_for:-:B return:-:A
where is new orleans ?	add_node:-:B add_node:-:A add_edge:-:_loc arg_node:-:B arg_node:-:A add_entity_node:-:new_orleans:=:city arg_node:-:B return:-:A
in what state is mount mckinley ?	add_node:-:B add_node:-:A add_edge:-:_loc arg_node:-:B arg_node:-:A add_type_node:-:_state arg_node:-:A add_entity_node:-:mount_mckinley:=:place arg_node:-:B return:-:A
what state has highest elevation ?	add_node:-:A add_type_node:-:_state arg_node:-:A add_node:-:B add_edge:-:_loc arg_node:-:B arg_node:-:A add_operation:-:_highest add_type_node:-:_place arg_node:-:B end_operation:-:arg ope_for:-:B return:-:A
what is the size of california ?	add_node:-:B add_node:-:A add_edge:-:_size arg_node:-:B arg_node:-:A add_entity_node:-:california:=:state arg_node:-:B return:-:A
what is the smallest state that borders texas ?	add_operation:-:_smallest add_node:-:A add_type_node:-:_state arg_node:-:A add_node:-:B add_edge:-:_next_to arg_node:-:A arg_node:-:B add_entity_node:-:texas:=:state arg_node:-:B end_operation:-:arg ope_for:-:A return:-:A
how many citizens in alabama ?	add_node:-:B add_node:-:A add_edge:-:_population arg_node:-:B arg_node:-:A add_entity_node:-:alabama:=:state arg_node:-:B return:-:A
in which state is rochester ?	add_node:-:B add_node:-:A add_edge:-:_loc arg_node:-:B arg_node:-:A add_type_node:-:_state arg_node:-:A add_entity_node:-:rochester:=:city arg_node:-:B return:-:A
how many states in the us does the shortest river run through ?	add_operation:-:_count add_node:-:B add_type_node:-:_state arg_node:-:B add_node:-:C add_edge:-:_loc arg_node:-:B arg_node:-:C add_entity_node:-:usa:=:country arg_node:-:C add_node:-:D add_edge:-:_traverse arg_node:-:D arg_node:-:B add_operation:-:_shortest add_type_node:-:_river arg_node:-:D end_operation:-:arg ope_for:-:D end_operation:-:_count ope_for:-:B ope_return:-:A return:-:A
what is the biggest state in continental us ?	add_operation:-:_largest add_node:-:A add_type_node:-:_state arg_node:-:A add_node:-:B add_edge:-:_loc arg_node:-:A arg_node:-:B add_entity_node:-:usa:=:country arg_node:-:B end_operation:-:arg ope_for:-:A return:-:A
what is the area of the largest state ?	add_node:-:B add_node:-:A add_edge:-:_area arg_node:-:B arg_node:-:A add_operation:-:_largest add_type_node:-:_state arg_node:-:B end_operation:-:arg ope_for:-:B return:-:A
where is mount whitney ?	add_node:-:B add_node:-:A add_edge:-:_loc arg_node:-:B arg_node:-:A add_entity_node:-:mount_whitney:=:place arg_node:-:B return:-:A
how many states does iowa border ?	add_operation:-:_count add_node:-:B add_type_node:-:_state arg_node:-:B add_node:-:C add_edge:-:_next_to arg_node:-:C arg_node:-:B add_entity_node:-:iowa:=:state arg_node:-:C end_operation:-:_count ope_for:-:B ope_return:-:A return:-:A
which states does the longest river cross ?	add_node:-:A add_type_node:-:_state arg_node:-:A add_node:-:B add_edge:-:_traverse arg_node:-:B arg_node:-:A add_operation:-:_longest add_type_node:-:_river arg_node:-:B end_operation:-:arg ope_for:-:B return:-:A
what river flows through kansas ?	add_node:-:A add_type_node:-:_river arg_node:-:A add_node:-:B add_edge:-:_traverse arg_node:-:A arg_node:-:B add_entity_node:-:kansas:=:state arg_node:-:B return:-:A
what is the population of austin texas ?	add_node:-:B add_node:-:A add_edge:-:_population arg_node:-:B arg_node:-:A add_entity_node:-:austin_tx:=:city arg_node:-:B return:-:A
what is the capital of vermont ?	add_node:-:A add_type_node:-:_capital arg_node:-:A add_node:-:B add_edge:-:_loc arg_node:-:A arg_node:-:B add_entity_node:-:vermont:=:state arg_node:-:B return:-:A
which states border colorado ?	add_node:-:A add_type_node:-:_state arg_node:-:A add_node:-:B add_edge:-:_next_to arg_node:-:A arg_node:-:B add_entity_node:-:colorado:=:state arg_node:-:B return:-:A
how long is the mississippi ?	add_node:-:B add_node:-:A add_edge:-:_len arg_node:-:B arg_node:-:A add_entity_node:-:mississippi:=:river arg_node:-:B return:-:A
what state has the largest population density ?	add_operation:-:_largest add_node:-:A add_type_node:-:_state arg_node:-:A add_node:-:B add_edge:-:_density arg_node:-:A arg_node:-:B end_operation:-:arg ope_for:-:B return:-:A
what states border georgia ?	add_node:-:A add_type_node:-:_state arg_node:-:A add_node:-:B add_edge:-:_next_to arg_node:-:A arg_node:-:B add_entity_node:-:georgia:=:state arg_node:-:B return:-:A
what is the capital of pennsylvania ?	add_node:-:A add_type_node:-:_capital arg_node:-:A add_node:-:B add_edge:-:_loc arg_node:-:A arg_node:-:B add_entity_node:-:pennsylvania:=:state arg_node:-:B return:-:A
what are the biggest rivers in texas ?	add_operation:-:_longest add_node:-:A add_type_node:-:_river arg_node:-:A add_node:-:B add_edge:-:_loc arg_node:-:A arg_node:-:B add_entity_node:-:texas:=:state arg_node:-:B end_operation:-:arg ope_for:-:A return:-:A
what is the longest river in the united states ?	add_operation:-:_longest add_node:-:A add_type_node:-:_river arg_node:-:A add_node:-:B add_edge:-:_loc arg_node:-:A arg_node:-:B add_entity_node:-:usa:=:country arg_node:-:B end_operation:-:arg ope_for:-:A return:-:A
what is the capital of utah ?	add_node:-:A add_type_node:-:_capital arg_node:-:A add_node:-:B add_edge:-:_loc arg_node:-:A arg_node:-:B add_entity_node:-:utah:=:state arg_node:-:B return:-:A
what state has the smallest population density ?	add_operation:-:_smallest add_node:-:A add_type_node:-:_state arg_node:-:A add_node:-:B add_edge:-:_density arg_node:-:A arg_node:-:B end_operation:-:arg ope_for:-:B return:-:A
which capitals are not major cities ?	add_node:-:A add_type_node:-:_capital arg_node:-:A add_operation:-:_not add_type_node:-:_major arg_node:-:A add_type_node:-:_city arg_node:-:A end_operation:-:_not return:-:A
what is the biggest city in nebraska ?	add_operation:-:_largest add_node:-:A add_type_node:-:_city arg_node:-:A add_node:-:B add_edge:-:_loc arg_node:-:A arg_node:-:B add_entity_node:-:nebraska:=:state arg_node:-:B end_operation:-:arg ope_for:-:A return:-:A
what is the population of texas ?	add_node:-:B add_node:-:A add_edge:-:_population arg_node:-:B arg_node:-:A add_entity_node:-:texas:=:state arg_node:-:B return:-:A
what is the shortest river in the united states ?	add_operation:-:_shortest add_node:-:A add_type_node:-:_river arg_node:-:A add_node:-:B add_edge:-:_loc arg_node:-:A arg_node:-:B add_entity_node:-:usa:=:country arg_node:-:B end_operation:-:arg ope_for:-:A return:-:A
what is the population of rhode island ?	add_node:-:B add_node:-:A add_edge:-:_population arg_node:-:B arg_node:-:A add_entity_node:-:rhode_island:=:state arg_node:-:B return:-:A
what is the state with the lowest point ?	add_node:-:A add_type_node:-:_state arg_node:-:A add_node:-:B add_edge:-:_loc arg_node:-:B arg_node:-:A add_operation:-:_lowest add_type_node:-:_place arg_node:-:B end_operation:-:arg ope_for:-:B return:-:A
what is the longest river in new york ?	add_operation:-:_longest add_node:-:A add_type_node:-:_river arg_node:-:A add_node:-:B add_edge:-:_loc arg_node:-:A arg_node:-:B add_entity_node:-:new_york:=:state arg_node:-:B end_operation:-:arg ope_for:-:A return:-:A
what is the longest river that runs through a state that borders tennessee ?	add_operation:-:_longest add_node:-:A add_type_node:-:_river arg_node:-:A add_node:-:B add_edge:-:_traverse arg_node:-:A arg_node:-:B add_type_node:-:_state arg_node:-:B add_node:-:C add_edge:-:_next_to arg_node:-:B arg_node:-:C add_entity_node:-:tennessee:=:state arg_node:-:C end_operation:-:arg ope_for:-:A return:-:A
how many major cities are in arizona ?	add_operation:-:_count add_node:-:B add_type_node:-:_major arg_node:-:B add_type_node:-:_city arg_node:-:B add_node:-:C add_edge:-:_loc arg_node:-:B arg_node:-:C add_entity_node:-:arizona:=:state arg_node:-:C end_operation:-:_count ope_for:-:B ope_return:-:A return:-:A
what are the neighboring states for michigan ?	add_node:-:A add_node:-:B add_edge:-:_next_to arg_node:-:A arg_node:-:B add_type_node:-:_state arg_node:-:A add_entity_node:-:michigan:=:state arg_node:-:B return:-:A
what state that borders texas is the largest ?	add_operation:-:_largest add_node:-:A add_type_node:-:_state arg_node:-:A add_node:-:B add_edge:-:_next_to arg_node:-:A arg_node:-:B add_entity_node:-:texas:=:state arg_node:-:B end_operation:-:arg ope_for:-:A return:-:A
what is the shortest river ?	add_operation:-:_shortest add_node:-:A add_type_node:-:_river arg_node:-:A end_operation:-:arg ope_for:-:A return:-:A
how many states border the state that borders the most states ?	add_operation:-:_count add_node:-:B add_type_node:-:_state arg_node:-:B add_node:-:C add_edge:-:_next_to arg_node:-:B arg_node:-:C add_operation:-:_most add_type_node:-:_state arg_node:-:C add_node:-:D add_edge:-:_next_to arg_node:-:C arg_node:-:D add_type_node:-:_state arg_node:-:D end_operation:-:arg_count ope_for:-:C ope_for:-:D end_operation:-:_count ope_for:-:B ope_return:-:A return:-:A
which state is the largest city in montana in ?	add_node:-:A add_type_node:-:_state arg_node:-:A add_node:-:B add_edge:-:_loc arg_node:-:B arg_node:-:A add_operation:-:_largest add_type_node:-:_city arg_node:-:B add_node:-:C add_edge:-:_loc arg_node:-:B arg_node:-:C add_entity_node:-:montana:=:state arg_node:-:C end_operation:-:arg ope_for:-:B return:-:A
what is the population of washington dc ?	add_node:-:B add_node:-:A add_edge:-:_population arg_node:-:B arg_node:-:A add_entity_node:-:washington_dc:=:city arg_node:-:B return:-:A
what is the most populous city in texas ?	add_operation:-:_largest add_node:-:B add_node:-:A add_edge:-:_population arg_node:-:B arg_node:-:A add_type_node:-:_city arg_node:-:B add_node:-:C add_edge:-:_loc arg_node:-:B arg_node:-:C add_entity_node:-:texas:=:state arg_node:-:C end_operation:-:arg ope_for:-:A return:-:B
what is the capital of hawaii ?	add_node:-:A add_type_node:-:_capital arg_node:-:A add_node:-:B add_edge:-:_loc arg_node:-:A arg_node:-:B add_entity_node:-:hawaii:=:state arg_node:-:B return:-:A
what is capital of iowa ?	add_node:-:A add_type_node:-:_capital arg_node:-:A add_node:-:B add_edge:-:_loc arg_node:-:A arg_node:-:B add_entity_node:-:iowa:=:state arg_node:-:B return:-:A
where is san diego ?	add_node:-:B add_node:-:A add_edge:-:_loc arg_node:-:B arg_node:-:A add_entity_node:-:san_diego:=:city arg_node:-:B return:-:A
what are the major cities in delaware ?	add_node:-:A add_type_node:-:_major arg_node:-:A add_type_node:-:_city arg_node:-:A add_node:-:B add_edge:-:_loc arg_node:-:A arg_node:-:B add_entity_node:-:delaware:=:state arg_node:-:B return:-:A
what is the lowest point in louisiana ?	add_operation:-:_lowest add_node:-:A add_type_node:-:_place arg_node:-:A add_node:-:B add_edge:-:_loc arg_node:-:A arg_node:-:B add_entity_node:-:louisiana:=:state arg_node:-:B end_operation:-:arg ope_for:-:A return:-:A
which state has the highest peak in the country ?	add_operation:-:_highest add_node:-:A add_type_node:-:_state arg_node:-:A add_node:-:B add_edge:-:_loc arg_node:-:B arg_node:-:A add_type_node:-:_mountain arg_node:-:B end_operation:-:arg ope_for:-:B return:-:A
what texas city has the largest population ?	add_operation:-:_largest add_node:-:C add_entity_node:-:texas:=:state arg_node:-:C add_node:-:A add_edge:-:_loc arg_node:-:A arg_node:-:C add_node:-:B add_edge:-:_population arg_node:-:A arg_node:-:B add_type_node:-:_city arg_node:-:A end_operation:-:arg ope_for:-:B return:-:A
what capital is the largest in the us ?	add_operation:-:_largest add_node:-:A add_type_node:-:_capital arg_node:-:A add_node:-:B add_edge:-:_loc arg_node:-:A arg_node:-:B add_entity_node:-:usa:=:country arg_node:-:B end_operation:-:arg ope_for:-:A return:-:A
what is the population of new york ?	add_node:-:B add_node:-:A add_edge:-:_population arg_node:-:B arg_node:-:A add_entity_node:-:new_york:=:state arg_node:-:B return:-:A
what is the population of the capital of the smallest state ?	add_node:-:B add_node:-:A add_edge:-:_population arg_node:-:B arg_node:-:A add_type_node:-:_capital arg_node:-:B add_node:-:C add_edge:-:_loc arg_node:-:B arg_node:-:C add_operation:-:_smallest add_type_node:-:_state arg_node:-:C end_operation:-:arg ope_for:-:C return:-:A
what is the area of alaska ?	add_node:-:B add_node:-:A add_edge:-:_area arg_node:-:B arg_node:-:A add_entity_node:-:alaska:=:state arg_node:-:B return:-:A
what is the population of california ?	add_node:-:B add_node:-:A add_edge:-:_population arg_node:-:B arg_node:-:A add_entity_node:-:california:=:state arg_node:-:B return:-:A
which state has the longest river ?	add_operation:-:_longest add_node:-:A add_type_node:-:_state arg_node:-:A add_node:-:B add_edge:-:_loc arg_node:-:B arg_node:-:A add_type_node:-:_river arg_node:-:B end_operation:-:arg ope_for:-:B return:-:A
what is the capital of texas ?	add_node:-:A add_type_node:-:_capital arg_node:-:A add_node:-:B add_edge:-:_loc arg_node:-:A arg_node:-:B add_entity_node:-:texas:=:state arg_node:-:B return:-:A
give me the cities which are in texas ?	add_node:-:A add_type_node:-:_city arg_node:-:A add_node:-:B add_edge:-:_loc arg_node:-:A arg_node:-:B add_entity_node:-:texas:=:state arg_node:-:B return:-:A
what states border kentucky ?	add_node:-:A add_type_node:-:_state arg_node:-:A add_node:-:B add_edge:-:_next_to arg_node:-:A arg_node:-:B add_entity_node:-:kentucky:=:state arg_node:-:B return:-:A
how high is the highest point of florida ?	add_node:-:B add_node:-:A add_edge:-:_elevation arg_node:-:B arg_node:-:A add_operation:-:_highest add_type_node:-:_place arg_node:-:B add_node:-:C add_edge:-:_loc arg_node:-:B arg_node:-:C add_entity_node:-:florida:=:state arg_node:-:C end_operation:-:arg ope_for:-:B return:-:A
what are the major cities in north carolina ?	add_node:-:A add_type_node:-:_major arg_node:-:A add_type_node:-:_city arg_node:-:A add_node:-:B add_edge:-:_loc arg_node:-:A arg_node:-:B add_entity_node:-:north_carolina:=:state arg_node:-:B return:-:A
what is the highest point in the state with capital des moines ?	add_operation:-:_highest add_node:-:A add_type_node:-:_place arg_node:-:A add_node:-:B add_edge:-:_loc arg_node:-:A arg_node:-:B add_type_node:-:_state arg_node:-:B add_node:-:C add_edge:-:_loc arg_node:-:C arg_node:-:B add_type_node:-:_capital arg_node:-:C add_entity_node:-:des_moines:=:city arg_node:-:C end_operation:-:arg ope_for:-:A return:-:A
what is the lowest point in california ?	add_operation:-:_lowest add_node:-:A add_type_node:-:_place arg_node:-:A add_node:-:B add_edge:-:_loc arg_node:-:A arg_node:-:B add_entity_node:-:california:=:state arg_node:-:B end_operation:-:arg ope_for:-:A return:-:A
what is the biggest city in wyoming ?	add_operation:-:_largest add_node:-:A add_type_node:-:_city arg_node:-:A add_node:-:B add_edge:-:_loc arg_node:-:A arg_node:-:B add_entity_node:-:wyoming:=:state arg_node:-:B end_operation:-:arg ope_for:-:A return:-:A
what is the largest state bordering texas ?	add_operation:-:_largest add_node:-:A add_type_node:-:_state arg_node:-:A add_node:-:B add_edge:-:_next_to arg_node:-:A arg_node:-:B add_entity_node:-:texas:=:state arg_node:-:B end_operation:-:arg ope_for:-:A return:-:A
what is the smallest city in hawaii ?	add_operation:-:_smallest add_node:-:A add_type_node:-:_city arg_node:-:A add_node:-:B add_edge:-:_loc arg_node:-:A arg_node:-:B add_entity_node:-:hawaii:=:state arg_node:-:B end_operation:-:arg ope_for:-:A return:-:A
what is the area of the states ?	add_node:-:B add_node:-:A add_edge:-:_area arg_node:-:B arg_node:-:A add_type_node:-:_state arg_node:-:B return:-:A
what is the area of idaho ?	add_node:-:B add_node:-:A add_edge:-:_area arg_node:-:B arg_node:-:A add_entity_node:-:idaho:=:state arg_node:-:B return:-:A
what state has the most rivers running through it ?	add_operation:-:_most add_node:-:A add_type_node:-:_state arg_node:-:A add_node:-:B add_edge:-:_loc arg_node:-:B arg_node:-:A add_type_node:-:_river arg_node:-:B add_edge:-:_traverse arg_node:-:B arg_node:-:A end_operation:-:arg_count ope_for:-:A ope_for:-:B return:-:A
what is the population of springfield missouri ?	add_node:-:B add_node:-:A add_edge:-:_population arg_node:-:B arg_node:-:A add_entity_node:-:springfield_mo:=:city arg_node:-:B return:-:A
what is the most populated state bordering oklahoma ?	add_operation:-:_largest add_node:-:A add_node:-:B add_edge:-:_population arg_node:-:A arg_node:-:B add_type_node:-:_state arg_node:-:A add_node:-:C add_edge:-:_next_to arg_node:-:A arg_node:-:C add_entity_node:-:oklahoma:=:state arg_node:-:C end_operation:-:arg ope_for:-:B return:-:A
what is the number of neighboring states for kentucky ?	add_operation:-:_count add_node:-:B add_type_node:-:_state arg_node:-:B add_node:-:C add_edge:-:_next_to arg_node:-:B arg_node:-:C add_entity_node:-:kentucky:=:state arg_node:-:C end_operation:-:_count ope_for:-:B ope_return:-:A return:-:A
what is the average population per square km in pennsylvania ?	add_node:-:B add_node:-:A add_edge:-:_density arg_node:-:B arg_node:-:A add_entity_node:-:pennsylvania:=:state arg_node:-:B return:-:A
what state has the highest population density ?	add_operation:-:_largest add_node:-:A add_type_node:-:_state arg_node:-:A add_node:-:B add_edge:-:_density arg_node:-:A arg_node:-:B end_operation:-:arg ope_for:-:B return:-:A
what is the tallest mountain in america ?	add_operation:-:_highest add_node:-:A add_type_node:-:_mountain arg_node:-:A add_node:-:B add_edge:-:_loc arg_node:-:A arg_node:-:B add_entity_node:-:usa:=:country arg_node:-:B end_operation:-:arg ope_for:-:A return:-:A
what is the highest point of the state with the largest area ?	add_operation:-:_highest add_node:-:A add_type_node:-:_place arg_node:-:A add_node:-:B add_edge:-:_loc arg_node:-:A arg_node:-:B add_operation:-:_largest add_type_node:-:_state arg_node:-:B add_node:-:C add_edge:-:_area arg_node:-:B arg_node:-:C end_operation:-:arg ope_for:-:C end_operation:-:arg ope_for:-:A return:-:A
what are the states ?	add_node:-:A add_type_node:-:_state arg_node:-:A return:-:A
how many rivers in washington ?	add_operation:-:_count add_node:-:B add_type_node:-:_river arg_node:-:B add_node:-:C add_edge:-:_loc arg_node:-:B arg_node:-:C add_entity_node:-:washington:=:state arg_node:-:C end_operation:-:_count ope_for:-:B ope_return:-:A return:-:A
what are the populations of the states through which the mississippi river run ?	add_node:-:B add_node:-:A add_edge:-:_population arg_node:-:B arg_node:-:A add_type_node:-:_state arg_node:-:B add_node:-:C add_edge:-:_traverse arg_node:-:C arg_node:-:B add_entity_node:-:mississippi:=:river arg_node:-:C add_type_node:-:_river arg_node:-:C return:-:A
what is the biggest river in illinois ?	add_operation:-:_largest add_node:-:A add_type_node:-:_river arg_node:-:A add_node:-:B add_edge:-:_loc arg_node:-:A arg_node:-:B add_entity_node:-:illinois:=:state arg_node:-:B end_operation:-:arg ope_for:-:A return:-:A
what is the capital of michigan ?	add_node:-:A add_type_node:-:_capital arg_node:-:A add_node:-:B add_edge:-:_loc arg_node:-:A arg_node:-:B add_entity_node:-:michigan:=:state arg_node:-:B return:-:A
what is the total population of the states that border texas ?	add_operation:-:_sum add_node:-:C add_type_node:-:_state arg_node:-:C add_node:-:D add_edge:-:_next_to arg_node:-:D arg_node:-:C add_entity_node:-:texas:=:state arg_node:-:D add_type_node:-:_population arg_node:-:C end_operation:-:_sum ope_for:-:C ope_in:-:_population ope_return:-:A return:-:A
what states border rhode island ?	add_node:-:A add_type_node:-:_state arg_node:-:A add_node:-:B add_edge:-:_next_to arg_node:-:A arg_node:-:B add_entity_node:-:rhode_island:=:state arg_node:-:B return:-:A
what is the biggest city in oregon ?	add_operation:-:_largest add_node:-:A add_type_node:-:_city arg_node:-:A add_node:-:B add_edge:-:_loc arg_node:-:A arg_node:-:B add_entity_node:-:oregon:=:state arg_node:-:B end_operation:-:arg ope_for:-:A return:-:A
what is the lowest point in wisconsin ?	add_operation:-:_lowest add_node:-:A add_type_node:-:_place arg_node:-:A add_node:-:B add_edge:-:_loc arg_node:-:A arg_node:-:B add_entity_node:-:wisconsin:=:state arg_node:-:B end_operation:-:arg ope_for:-:A return:-:A
what are the rivers in the state of indiana ?	add_node:-:A add_type_node:-:_river arg_node:-:A add_node:-:B add_edge:-:_loc arg_node:-:A arg_node:-:B add_type_node:-:_state arg_node:-:B add_entity_node:-:indiana:=:state arg_node:-:B return:-:A
what is the population of austin ?	add_node:-:B add_node:-:A add_edge:-:_population arg_node:-:B arg_node:-:A add_entity_node:-:austin:=:city arg_node:-:B return:-:A
what is the smallest city in arkansas ?	add_operation:-:_smallest add_node:-:A add_type_node:-:_city arg_node:-:A add_node:-:B add_edge:-:_loc arg_node:-:A arg_node:-:B add_entity_node:-:arkansas:=:state arg_node:-:B end_operation:-:arg ope_for:-:A return:-:A
give me the longest river that passes through the us ?	add_operation:-:_longest add_node:-:A add_type_node:-:_river arg_node:-:A add_node:-:B add_edge:-:_traverse arg_node:-:A arg_node:-:B add_entity_node:-:usa:=:country arg_node:-:B end_operation:-:arg ope_for:-:A return:-:A
how long is the missouri river ?	add_node:-:B add_node:-:A add_edge:-:_len arg_node:-:B arg_node:-:A add_entity_node:-:missouri:=:river arg_node:-:B add_type_node:-:_river arg_node:-:B return:-:A
which state has the largest city ?	add_operation:-:_largest add_node:-:A add_type_node:-:_state arg_node:-:A add_node:-:B add_edge:-:_loc arg_node:-:B arg_node:-:A add_type_node:-:_city arg_node:-:B end_operation:-:arg ope_for:-:B return:-:A
what is the lowest elevation in pennsylvania ?	add_operation:-:_lowest add_node:-:A add_type_node:-:_place arg_node:-:A add_node:-:B add_edge:-:_loc arg_node:-:A arg_node:-:B add_entity_node:-:pennsylvania:=:state arg_node:-:B end_operation:-:arg ope_for:-:A return:-:A
what is the longest river in the state with the highest point ?	add_operation:-:_longest add_node:-:A add_type_node:-:_river arg_node:-:A add_node:-:B add_edge:-:_loc arg_node:-:A arg_node:-:B add_type_node:-:_state arg_node:-:B add_node:-:C add_edge:-:_loc arg_node:-:C arg_node:-:B add_operation:-:_highest add_type_node:-:_place arg_node:-:C end_operation:-:arg ope_for:-:C end_operation:-:arg ope_for:-:A return:-:A
what states does the colorado river run through ?	add_node:-:A add_type_node:-:_state arg_node:-:A add_node:-:B add_edge:-:_traverse arg_node:-:B arg_node:-:A add_entity_node:-:colorado:=:river arg_node:-:B add_type_node:-:_river arg_node:-:B return:-:A
what are the states that the potomac run through ?	add_node:-:A add_type_node:-:_state arg_node:-:A add_node:-:B add_edge:-:_traverse arg_node:-:B arg_node:-:A add_entity_node:-:potomac:=:river arg_node:-:B return:-:A
what is the biggest city in the usa ?	add_operation:-:_largest add_node:-:A add_type_node:-:_city arg_node:-:A add_node:-:B add_edge:-:_loc arg_node:-:A arg_node:-:B add_entity_node:-:usa:=:country arg_node:-:B end_operation:-:arg ope_for:-:A return:-:A
what state has no rivers ?	add_node:-:A add_type_node:-:_state arg_node:-:A add_operation:-:_not add_node:-:B add_edge:-:_loc arg_node:-:B arg_node:-:A add_type_node:-:_river arg_node:-:B end_operation:-:_not return:-:A
what is the highest point in rhode island ?	add_operation:-:_highest add_node:-:A add_type_node:-:_place arg_node:-:A add_node:-:B add_edge:-:_loc arg_node:-:A arg_node:-:B add_entity_node:-:rhode_island:=:state arg_node:-:B end_operation:-:arg ope_for:-:A return:-:A
name the states which have no surrounding states ?	add_node:-:A add_type_node:-:_state arg_node:-:A add_operation:-:_not add_node:-:B add_edge:-:_next_to arg_node:-:A arg_node:-:B add_type_node:-:_state arg_node:-:B end_operation:-:_not return:-:A
what is the population of atlanta ga ?	add_node:-:B add_node:-:A add_edge:-:_population arg_node:-:B arg_node:-:A add_entity_node:-:atlanta:=:city arg_node:-:B return:-:A
how many square kilometers in the us ?	add_node:-:B add_node:-:A add_edge:-:_area arg_node:-:B arg_node:-:A add_entity_node:-:usa:=:country arg_node:-:B return:-:A
what is the population of idaho ?	add_node:-:B add_node:-:A add_edge:-:_population arg_node:-:B arg_node:-:A add_entity_node:-:idaho:=:state arg_node:-:B return:-:A
what is the adjacent state of california ?	add_node:-:A add_node:-:B add_edge:-:_next_to arg_node:-:A arg_node:-:B add_type_node:-:_state arg_node:-:A add_entity_node:-:california:=:state arg_node:-:B return:-:A
what is the smallest state through which the longest river runs ?	add_operation:-:_smallest add_node:-:A add_type_node:-:_state arg_node:-:A add_node:-:B add_edge:-:_traverse arg_node:-:B arg_node:-:A add_operation:-:_longest add_type_node:-:_river arg_node:-:B end_operation:-:arg ope_for:-:B end_operation:-:arg ope_for:-:A return:-:A
what are the names of the major cities in illinois ?	add_node:-:A add_type_node:-:_major arg_node:-:A add_type_node:-:_city arg_node:-:A add_node:-:B add_edge:-:_loc arg_node:-:A arg_node:-:B add_entity_node:-:illinois:=:state arg_node:-:B return:-:A
how many states does the colorado river run through ?	add_operation:-:_count add_node:-:B add_type_node:-:_state arg_node:-:B add_node:-:C add_edge:-:_traverse arg_node:-:C arg_node:-:B add_entity_node:-:colorado:=:river arg_node:-:C add_type_node:-:_river arg_node:-:C end_operation:-:_count ope_for:-:B ope_return:-:A return:-:A
how many states does the colorado river flow through ?	add_operation:-:_count add_node:-:B add_type_node:-:_state arg_node:-:B add_node:-:C add_edge:-:_traverse arg_node:-:C arg_node:-:B add_entity_node:-:colorado:=:river arg_node:-:C add_type_node:-:_river arg_node:-:C end_operation:-:_count ope_for:-:B ope_return:-:A return:-:A
what are the major cities in kansas ?	add_node:-:A add_type_node:-:_major arg_node:-:A add_type_node:-:_city arg_node:-:A add_node:-:B add_edge:-:_loc arg_node:-:A arg_node:-:B add_entity_node:-:kansas:=:state arg_node:-:B return:-:A
which states border texas ?	add_node:-:A add_type_node:-:_state arg_node:-:A add_node:-:B add_edge:-:_next_to arg_node:-:A arg_node:-:B add_entity_node:-:texas:=:state arg_node:-:B return:-:A
how many people live in new york ?	add_node:-:B add_node:-:A add_edge:-:_population arg_node:-:B arg_node:-:A add_entity_node:-:new_york:=:state arg_node:-:B return:-:A
what are the largest cities in the states that border the largest state ?	add_operation:-:_largest add_node:-:A add_type_node:-:_city arg_node:-:A add_node:-:B add_edge:-:_loc arg_node:-:A arg_node:-:B add_type_node:-:_state arg_node:-:B add_node:-:C add_edge:-:_next_to arg_node:-:B arg_node:-:C add_operation:-:_largest add_type_node:-:_state arg_node:-:C end_operation:-:arg ope_for:-:C end_operation:-:arg ope_for:-:A return:-:A
which states have points that are higher than the highest point in texas ?	add_node:-:A add_type_node:-:_state arg_node:-:A add_node:-:B add_edge:-:_loc arg_node:-:B arg_node:-:A add_node:-:C add_edge:-:_higher arg_node:-:B arg_node:-:C add_operation:-:_highest add_type_node:-:_place arg_node:-:C add_node:-:D add_edge:-:_loc arg_node:-:C arg_node:-:D add_entity_node:-:texas:=:state arg_node:-:D end_operation:-:arg ope_for:-:C add_type_node:-:_place arg_node:-:B return:-:A
what is the river that cross over ohio ?	add_node:-:A add_type_node:-:_river arg_node:-:A add_node:-:B add_edge:-:_traverse arg_node:-:A arg_node:-:B add_entity_node:-:ohio:=:state arg_node:-:B return:-:A
what is the largest city in michigan ?	add_operation:-:_largest add_node:-:A add_type_node:-:_city arg_node:-:A add_node:-:B add_edge:-:_loc arg_node:-:A arg_node:-:B add_entity_node:-:michigan:=:state arg_node:-:B end_operation:-:arg ope_for:-:A return:-:A
how many rivers are in the state with the highest point ?	add_operation:-:_count add_node:-:B add_type_node:-:_river arg_node:-:B add_node:-:C add_edge:-:_loc arg_node:-:B arg_node:-:C add_type_node:-:_state arg_node:-:C add_node:-:D add_edge:-:_loc arg_node:-:D arg_node:-:C add_operation:-:_highest add_type_node:-:_place arg_node:-:D end_operation:-:arg ope_for:-:D end_operation:-:_count ope_for:-:B ope_return:-:A return:-:A
what cities are located in pennsylvania ?	add_node:-:A add_type_node:-:_city arg_node:-:A add_node:-:B add_edge:-:_loc arg_node:-:A arg_node:-:B add_entity_node:-:pennsylvania:=:state arg_node:-:B return:-:A
what is the state with the lowest population ?	add_operation:-:_smallest add_node:-:A add_type_node:-:_state arg_node:-:A add_node:-:B add_edge:-:_population arg_node:-:A arg_node:-:B end_operation:-:arg ope_for:-:B return:-:A
what is the highest point in each state whose lowest point is sea level ?	add_node:-:B add_node:-:A add_edge:-:_high_point arg_node:-:B arg_node:-:A add_type_node:-:_state arg_node:-:B add_node:-:C add_edge:-:_low_point arg_node:-:B arg_node:-:C add_type_node:-:_elevation arg_node:-:C return:-:A
give me the cities in usa ?	add_node:-:A add_type_node:-:_city arg_node:-:A add_node:-:B add_edge:-:_loc arg_node:-:A arg_node:-:B add_entity_node:-:usa:=:country arg_node:-:B return:-:A
how many states does the missouri river run through ?	add_operation:-:_count add_node:-:B add_type_node:-:_state arg_node:-:B add_node:-:C add_edge:-:_traverse arg_node:-:C arg_node:-:B add_entity_node:-:missouri:=:river arg_node:-:C add_type_node:-:_river arg_node:-:C end_operation:-:_count ope_for:-:B ope_return:-:A return:-:A
what state has the city with the largest population ?	add_node:-:A add_type_node:-:_state arg_node:-:A add_node:-:B add_edge:-:_loc arg_node:-:B arg_node:-:A add_operation:-:_largest add_type_node:-:_city arg_node:-:B add_node:-:C add_edge:-:_population arg_node:-:B arg_node:-:C end_operation:-:arg ope_for:-:C return:-:A
which is the shortest river ?	add_operation:-:_shortest add_node:-:A add_type_node:-:_river arg_node:-:A end_operation:-:arg ope_for:-:A return:-:A
how many states border alaska ?	add_operation:-:_count add_node:-:B add_type_node:-:_state arg_node:-:B add_node:-:C add_edge:-:_next_to arg_node:-:B arg_node:-:C add_entity_node:-:alaska:=:state arg_node:-:C end_operation:-:_count ope_for:-:B ope_return:-:A return:-:A
what is the population of dallas ?	add_node:-:B add_node:-:A add_edge:-:_population arg_node:-:B arg_node:-:A add_entity_node:-:dallas:=:city arg_node:-:B return:-:A
where is san jose ?	add_node:-:B add_node:-:A add_edge:-:_loc arg_node:-:B arg_node:-:A add_entity_node:-:san_jose:=:city arg_node:-:B return:-:A
what states border states that border colorado ?	add_node:-:A add_type_node:-:_state arg_node:-:A add_node:-:B add_edge:-:_next_to arg_node:-:A arg_node:-:B add_type_node:-:_state arg_node:-:B add_node:-:C add_edge:-:_next_to arg_node:-:B arg_node:-:C add_entity_node:-:colorado:=:state arg_node:-:C return:-:A
what rivers flow through the state with the largest population ?	add_node:-:A add_type_node:-:_river arg_node:-:A add_node:-:B add_edge:-:_traverse arg_node:-:A arg_node:-:B add_operation:-:_largest add_type_node:-:_state arg_node:-:B add_node:-:C add_edge:-:_population arg_node:-:B arg_node:-:C end_operation:-:arg ope_for:-:C return:-:A
whats the largest city ?	add_operation:-:_largest add_node:-:A add_type_node:-:_city arg_node:-:A end_operation:-:arg ope_for:-:A return:-:A
what is the capital of the alabama state ?	add_node:-:A add_type_node:-:_capital arg_node:-:A add_node:-:B add_edge:-:_loc arg_node:-:A arg_node:-:B add_entity_node:-:alabama:=:state arg_node:-:B add_type_node:-:_state arg_node:-:B return:-:A
what states border arkansas ?	add_node:-:A add_type_node:-:_state arg_node:-:A add_node:-:B add_edge:-:_next_to arg_node:-:A arg_node:-:B add_entity_node:-:arkansas:=:state arg_node:-:B return:-:A
what is the population of denver ?	add_node:-:B add_node:-:A add_edge:-:_population arg_node:-:B arg_node:-:A add_entity_node:-:denver:=:city arg_node:-:B return:-:A
what is the longest river in america ?	add_operation:-:_longest add_node:-:A add_type_node:-:_river arg_node:-:A add_node:-:B add_edge:-:_loc arg_node:-:A arg_node:-:B add_entity_node:-:usa:=:country arg_node:-:B end_operation:-:arg ope_for:-:A return:-:A
where is massachusetts ?	add_node:-:B add_node:-:A add_edge:-:_loc arg_node:-:B arg_node:-:A add_entity_node:-:massachusetts:=:state arg_node:-:B return:-:A
what state has the smallest area ?	add_operation:-:_smallest add_node:-:A add_type_node:-:_state arg_node:-:A add_node:-:B add_edge:-:_area arg_node:-:A arg_node:-:B end_operation:-:arg ope_for:-:B return:-:A
what major rivers run through illinois ?	add_node:-:A add_type_node:-:_major arg_node:-:A add_type_node:-:_river arg_node:-:A add_node:-:B add_edge:-:_traverse arg_node:-:A arg_node:-:B add_entity_node:-:illinois:=:state arg_node:-:B return:-:A
how many cities does the usa have ?	add_operation:-:_count add_node:-:B add_type_node:-:_city arg_node:-:B add_node:-:C add_edge:-:_loc arg_node:-:B arg_node:-:C add_entity_node:-:usa:=:country arg_node:-:C end_operation:-:_count ope_for:-:B ope_return:-:A return:-:A
how many people live in california ?	add_node:-:B add_node:-:A add_edge:-:_population arg_node:-:B arg_node:-:A add_entity_node:-:california:=:state arg_node:-:B return:-:A
what are the major rivers in the us ?	add_node:-:A add_type_node:-:_major arg_node:-:A add_type_node:-:_river arg_node:-:A add_node:-:B add_edge:-:_loc arg_node:-:A arg_node:-:B add_entity_node:-:usa:=:country arg_node:-:B return:-:A
how many states does the mississippi river run through ?	add_operation:-:_count add_node:-:B add_type_node:-:_state arg_node:-:B add_node:-:C add_edge:-:_traverse arg_node:-:C arg_node:-:B add_entity_node:-:mississippi:=:river arg_node:-:C add_type_node:-:_river arg_node:-:C end_operation:-:_count ope_for:-:B ope_return:-:A return:-:A
what is the area of texas ?	add_node:-:B add_node:-:A add_edge:-:_area arg_node:-:B arg_node:-:A add_entity_node:-:texas:=:state arg_node:-:B return:-:A
what is the length of the river that traverses the most states ?	add_node:-:B add_node:-:A add_edge:-:_len arg_node:-:B arg_node:-:A add_operation:-:_most add_type_node:-:_river arg_node:-:B add_node:-:C add_edge:-:_traverse arg_node:-:B arg_node:-:C add_type_node:-:_state arg_node:-:C end_operation:-:arg_count ope_for:-:B ope_for:-:C return:-:A
what is the length of the longest river in the usa ?	add_node:-:B add_node:-:A add_edge:-:_len arg_node:-:B arg_node:-:A add_operation:-:_longest add_type_node:-:_river arg_node:-:B add_node:-:C add_edge:-:_loc arg_node:-:B arg_node:-:C add_entity_node:-:usa:=:country arg_node:-:C end_operation:-:arg ope_for:-:B return:-:A
can you tell me the capital of texas ?	add_node:-:A add_type_node:-:_capital arg_node:-:A add_node:-:B add_edge:-:_loc arg_node:-:A arg_node:-:B add_entity_node:-:texas:=:state arg_node:-:B return:-:A
what is the largest city in minnesota by population ?	add_operation:-:_largest add_node:-:A add_type_node:-:_city arg_node:-:A add_node:-:C add_edge:-:_loc arg_node:-:A arg_node:-:C add_entity_node:-:minnesota:=:state arg_node:-:C add_node:-:B add_edge:-:_population arg_node:-:A arg_node:-:B end_operation:-:arg ope_for:-:B return:-:A
what is the smallest state in the usa ?	add_operation:-:_smallest add_node:-:A add_type_node:-:_state arg_node:-:A add_node:-:B add_edge:-:_loc arg_node:-:A arg_node:-:B add_entity_node:-:usa:=:country arg_node:-:B end_operation:-:arg ope_for:-:A return:-:A
what states neighbor maine ?	add_node:-:A add_type_node:-:_state arg_node:-:A add_node:-:B add_edge:-:_next_to arg_node:-:A arg_node:-:B add_entity_node:-:maine:=:state arg_node:-:B return:-:A
what states high point are higher than that of colorado ?	add_node:-:A add_type_node:-:_state arg_node:-:A add_node:-:B add_edge:-:_high_point arg_node:-:A arg_node:-:B add_node:-:C add_edge:-:_higher arg_node:-:B arg_node:-:C add_node:-:D add_edge:-:_high_point arg_node:-:D arg_node:-:C add_entity_node:-:colorado:=:state arg_node:-:D return:-:A
what is the highest mountain in texas ?	add_operation:-:_highest add_node:-:A add_type_node:-:_mountain arg_node:-:A add_node:-:B add_edge:-:_loc arg_node:-:A arg_node:-:B add_entity_node:-:texas:=:state arg_node:-:B end_operation:-:arg ope_for:-:A return:-:A
what are the major cities in texas ?	add_node:-:A add_type_node:-:_major arg_node:-:A add_type_node:-:_city arg_node:-:A add_node:-:B add_edge:-:_loc arg_node:-:A arg_node:-:B add_entity_node:-:texas:=:state arg_node:-:B return:-:A
what are the states that border the state with the greatest population ?	add_node:-:A add_type_node:-:_state arg_node:-:A add_node:-:B add_edge:-:_next_to arg_node:-:B arg_node:-:A add_operation:-:_largest add_type_node:-:_state arg_node:-:B add_node:-:C add_edge:-:_population arg_node:-:B arg_node:-:C end_operation:-:arg ope_for:-:C return:-:A
what rivers run through colorado ?	add_node:-:A add_type_node:-:_river arg_node:-:A add_node:-:B add_edge:-:_traverse arg_node:-:A arg_node:-:B add_entity_node:-:colorado:=:state arg_node:-:B return:-:A
how many rivers are there in us ?	add_operation:-:_count add_node:-:B add_type_node:-:_river arg_node:-:B add_node:-:C add_edge:-:_loc arg_node:-:B arg_node:-:C add_entity_node:-:usa:=:country arg_node:-:C end_operation:-:_count ope_for:-:B ope_return:-:A return:-:A
how many rivers are in new york ?	add_operation:-:_count add_node:-:B add_type_node:-:_river arg_node:-:B add_node:-:C add_edge:-:_loc arg_node:-:B arg_node:-:C add_entity_node:-:new_york:=:state arg_node:-:C end_operation:-:_count ope_for:-:B ope_return:-:A return:-:A
which rivers are in alaska ?	add_node:-:A add_type_node:-:_river arg_node:-:A add_node:-:B add_edge:-:_loc arg_node:-:A arg_node:-:B add_entity_node:-:alaska:=:state arg_node:-:B return:-:A
what is the longest river flowing through new york ?	add_operation:-:_longest add_node:-:A add_type_node:-:_river arg_node:-:A add_node:-:B add_edge:-:_traverse arg_node:-:A arg_node:-:B add_entity_node:-:new_york:=:state arg_node:-:B end_operation:-:arg ope_for:-:A return:-:A
what rivers run through west virginia ?	add_node:-:A add_type_node:-:_river arg_node:-:A add_node:-:B add_edge:-:_traverse arg_node:-:A arg_node:-:B add_entity_node:-:west_virginia:=:state arg_node:-:B return:-:A
what are the capitals of the states that border texas ?	add_node:-:A add_type_node:-:_capital arg_node:-:A add_node:-:B add_edge:-:_loc arg_node:-:A arg_node:-:B add_type_node:-:_state arg_node:-:B add_node:-:C add_edge:-:_next_to arg_node:-:B arg_node:-:C add_entity_node:-:texas:=:state arg_node:-:C return:-:A
what is the area of california ?	add_node:-:B add_node:-:A add_edge:-:_area arg_node:-:B arg_node:-:A add_entity_node:-:california:=:state arg_node:-:B return:-:A
how many states have a city named springfield ?	add_operation:-:_count add_node:-:B add_type_node:-:_state arg_node:-:B add_node:-:C add_edge:-:_loc arg_node:-:C arg_node:-:B add_entity_node:-:springfield:=:city arg_node:-:C end_operation:-:_count ope_for:-:B ope_return:-:A return:-:A
what is the biggest city in texas ?	add_operation:-:_largest add_node:-:A add_type_node:-:_city arg_node:-:A add_node:-:B add_edge:-:_loc arg_node:-:A arg_node:-:B add_entity_node:-:texas:=:state arg_node:-:B end_operation:-:arg ope_for:-:A return:-:A
how many cities named austin are there in the usa ?	add_operation:-:_count add_node:-:B add_type_node:-:_city arg_node:-:B add_entity_node:-:austin:=:city arg_node:-:B add_node:-:C add_edge:-:_loc arg_node:-:B arg_node:-:C add_entity_node:-:usa:=:country arg_node:-:C end_operation:-:_count ope_for:-:B ope_return:-:A return:-:A
what are the major cities in the largest state ?	add_node:-:A add_type_node:-:_major arg_node:-:A add_type_node:-:_city arg_node:-:A add_node:-:B add_edge:-:_loc arg_node:-:A arg_node:-:B add_operation:-:_largest add_type_node:-:_state arg_node:-:B end_operation:-:arg ope_for:-:B return:-:A
which states does the colorado river run through ?	add_node:-:A add_type_node:-:_state arg_node:-:A add_node:-:B add_edge:-:_traverse arg_node:-:B arg_node:-:A add_entity_node:-:colorado:=:river arg_node:-:B return:-:A
what is the largest city in wisconsin ?	add_operation:-:_largest add_node:-:A add_type_node:-:_city arg_node:-:A add_node:-:B add_edge:-:_loc arg_node:-:A arg_node:-:B add_entity_node:-:wisconsin:=:state arg_node:-:B end_operation:-:arg ope_for:-:A return:-:A
how big is alaska ?	add_node:-:B add_node:-:A add_edge:-:_size arg_node:-:B arg_node:-:A add_entity_node:-:alaska:=:state arg_node:-:B return:-:A
what state contains the highest point in the us ?	add_node:-:A add_type_node:-:_state arg_node:-:A add_node:-:B add_edge:-:_loc arg_node:-:B arg_node:-:A add_operation:-:_highest add_type_node:-:_place arg_node:-:B add_node:-:C add_edge:-:_loc arg_node:-:B arg_node:-:C add_entity_node:-:usa:=:country arg_node:-:C end_operation:-:arg ope_for:-:B return:-:A
how big is north dakota ?	add_node:-:B add_node:-:A add_edge:-:_size arg_node:-:B arg_node:-:A add_entity_node:-:north_dakota:=:state arg_node:-:B return:-:A
which rivers flow through alaska ?	add_node:-:A add_type_node:-:_river arg_node:-:A add_node:-:B add_edge:-:_traverse arg_node:-:A arg_node:-:B add_entity_node:-:alaska:=:state arg_node:-:B return:-:A
what is the highest point in the us ?	add_operation:-:_highest add_node:-:A add_type_node:-:_place arg_node:-:A add_node:-:B add_edge:-:_loc arg_node:-:A arg_node:-:B add_entity_node:-:usa:=:country arg_node:-:B end_operation:-:arg ope_for:-:A return:-:A
what is the shortest river in texas ?	add_operation:-:_shortest add_node:-:A add_type_node:-:_river arg_node:-:A add_node:-:B add_edge:-:_loc arg_node:-:A arg_node:-:B add_entity_node:-:texas:=:state arg_node:-:B end_operation:-:arg ope_for:-:A return:-:A
what are the major cities in the states through which the major river in virginia runs ?	add_node:-:A add_type_node:-:_major arg_node:-:A add_type_node:-:_city arg_node:-:A add_node:-:B add_edge:-:_loc arg_node:-:A arg_node:-:B add_type_node:-:_state arg_node:-:B add_node:-:C add_edge:-:_traverse arg_node:-:C arg_node:-:B add_type_node:-:_river arg_node:-:C add_node:-:D add_edge:-:_loc arg_node:-:C arg_node:-:D add_entity_node:-:virginia:=:state arg_node:-:D return:-:A
what rivers are in oregon ?	add_node:-:A add_type_node:-:_river arg_node:-:A add_node:-:B add_edge:-:_loc arg_node:-:A arg_node:-:B add_entity_node:-:oregon:=:state arg_node:-:B return:-:A
what is the lowest point in the united states ?	add_operation:-:_lowest add_node:-:A add_type_node:-:_place arg_node:-:A add_node:-:B add_edge:-:_loc arg_node:-:A arg_node:-:B add_entity_node:-:usa:=:country arg_node:-:B end_operation:-:arg ope_for:-:A return:-:A
how many states have cities or towns named springfield ?	add_operation:-:_count add_node:-:B add_type_node:-:_state arg_node:-:B add_node:-:C add_edge:-:_loc arg_node:-:C arg_node:-:B add_type_node:-:_city arg_node:-:C add_entity_node:-:springfield:=:city arg_node:-:C end_operation:-:_count ope_for:-:B ope_return:-:A return:-:A
what is the population of south dakota ?	add_node:-:B add_node:-:A add_edge:-:_population arg_node:-:B arg_node:-:A add_entity_node:-:south_dakota:=:state arg_node:-:B return:-:A
what is the capital of the state with the highest point ?	add_node:-:A add_type_node:-:_capital arg_node:-:A add_node:-:B add_edge:-:_loc arg_node:-:A arg_node:-:B add_operation:-:_highest add_type_node:-:_state arg_node:-:B add_node:-:C add_edge:-:_loc arg_node:-:C arg_node:-:B add_type_node:-:_place arg_node:-:C end_operation:-:arg ope_for:-:C return:-:A
what state has the highest elevation ?	add_operation:-:_highest add_node:-:A add_type_node:-:_state arg_node:-:A add_node:-:B add_edge:-:_loc arg_node:-:B arg_node:-:A add_type_node:-:_place arg_node:-:B end_operation:-:arg ope_for:-:B return:-:A
what states are next to texas ?	add_node:-:A add_type_node:-:_state arg_node:-:A add_node:-:B add_edge:-:_next_to arg_node:-:A arg_node:-:B add_entity_node:-:texas:=:state arg_node:-:B return:-:A
what is the longest river that passes the states that border the state that borders the most states ?	add_operation:-:_longest add_node:-:A add_type_node:-:_river arg_node:-:A add_node:-:B add_edge:-:_traverse arg_node:-:A arg_node:-:B add_type_node:-:_state arg_node:-:B add_node:-:C add_edge:-:_next_to arg_node:-:B arg_node:-:C add_operation:-:_most add_type_node:-:_state arg_node:-:C add_node:-:D add_edge:-:_next_to arg_node:-:C arg_node:-:D add_type_node:-:_state arg_node:-:D end_operation:-:arg_count ope_for:-:C ope_for:-:D end_operation:-:arg ope_for:-:A return:-:A
which states border hawaii ?	add_node:-:A add_type_node:-:_state arg_node:-:A add_node:-:B add_edge:-:_next_to arg_node:-:A arg_node:-:B add_entity_node:-:hawaii:=:state arg_node:-:B return:-:A
how many major cities are there in oregon ?	add_operation:-:_count add_node:-:B add_type_node:-:_major arg_node:-:B add_type_node:-:_city arg_node:-:B add_node:-:C add_edge:-:_loc arg_node:-:B arg_node:-:C add_entity_node:-:oregon:=:state arg_node:-:C end_operation:-:_count ope_for:-:B ope_return:-:A return:-:A
what is the population of springfield south dakota ?	add_node:-:B add_node:-:A add_edge:-:_population arg_node:-:B arg_node:-:A add_entity_node:-:springfield_sd:=:city arg_node:-:B return:-:A
how many rivers run through texas ?	add_operation:-:_count add_node:-:B add_type_node:-:_river arg_node:-:B add_node:-:C add_edge:-:_traverse arg_node:-:B arg_node:-:C add_entity_node:-:texas:=:state arg_node:-:C end_operation:-:_count ope_for:-:B ope_return:-:A return:-:A
what state has the most major rivers running through it ?	add_operation:-:_most add_node:-:A add_type_node:-:_state arg_node:-:A add_node:-:B add_edge:-:_loc arg_node:-:B arg_node:-:A add_type_node:-:_major arg_node:-:B add_type_node:-:_river arg_node:-:B add_edge:-:_traverse arg_node:-:B arg_node:-:A end_operation:-:arg_count ope_for:-:A ope_for:-:B return:-:A
what are the lakes in states bordering texas ?	add_node:-:A add_type_node:-:_lake arg_node:-:A add_node:-:B add_edge:-:_loc arg_node:-:A arg_node:-:B add_type_node:-:_state arg_node:-:B add_node:-:C add_edge:-:_next_to arg_node:-:B arg_node:-:C add_entity_node:-:texas:=:state arg_node:-:C return:-:A
people in boulder ?	add_node:-:B add_node:-:A add_edge:-:_population arg_node:-:B arg_node:-:A add_entity_node:-:boulder:=:city arg_node:-:B return:-:A
what rivers are in nevada ?	add_node:-:A add_type_node:-:_river arg_node:-:A add_node:-:B add_edge:-:_loc arg_node:-:A arg_node:-:B add_entity_node:-:nevada:=:state arg_node:-:B return:-:A
where is fort wayne ?	add_node:-:B add_node:-:A add_edge:-:_loc arg_node:-:B arg_node:-:A add_entity_node:-:fort_wayne:=:city arg_node:-:B return:-:A
where is indianapolis ?	add_node:-:B add_node:-:A add_edge:-:_loc arg_node:-:B arg_node:-:A add_entity_node:-:indianapolis:=:city arg_node:-:B return:-:A
what states border states that border states that border states that border texas ?	add_node:-:A add_type_node:-:_state arg_node:-:A add_node:-:B add_edge:-:_next_to arg_node:-:A arg_node:-:B add_type_node:-:_state arg_node:-:B add_node:-:C add_edge:-:_next_to arg_node:-:B arg_node:-:C add_type_node:-:_state arg_node:-:C add_node:-:D add_edge:-:_next_to arg_node:-:C arg_node:-:D add_type_node:-:_state arg_node:-:D add_node:-:E add_edge:-:_next_to arg_node:-:D arg_node:-:E add_entity_node:-:texas:=:state arg_node:-:E return:-:A
population of boulder ?	add_node:-:B add_node:-:A add_edge:-:_population arg_node:-:B arg_node:-:A add_entity_node:-:boulder:=:city arg_node:-:B return:-:A
what are the major cities of the united states ?	add_node:-:A add_type_node:-:_major arg_node:-:A add_type_node:-:_city arg_node:-:A add_node:-:B add_edge:-:_loc arg_node:-:A arg_node:-:B add_entity_node:-:usa:=:country arg_node:-:B return:-:A
show major cities in colorado ?	add_node:-:A add_type_node:-:_major arg_node:-:A add_type_node:-:_city arg_node:-:A add_node:-:B add_edge:-:_loc arg_node:-:A arg_node:-:B add_entity_node:-:colorado:=:state arg_node:-:B return:-:A
what state is columbus the capital of ?	add_node:-:A add_type_node:-:_state arg_node:-:A add_node:-:B add_edge:-:_loc arg_node:-:B arg_node:-:A add_entity_node:-:columbus:=:city arg_node:-:B add_type_node:-:_capital arg_node:-:B return:-:A
what is the area of all the states combined ?	add_operation:-:_sum add_node:-:C add_type_node:-:_state arg_node:-:C add_type_node:-:_area arg_node:-:C end_operation:-:_sum ope_for:-:C ope_in:-:_area ope_return:-:A return:-:A
what is the average population per square km in the us ?	add_node:-:B add_node:-:A add_edge:-:_density arg_node:-:B arg_node:-:A add_entity_node:-:usa:=:country arg_node:-:B return:-:A
what is the largest state that borders california ?	add_operation:-:_largest add_node:-:A add_type_node:-:_state arg_node:-:A add_node:-:B add_edge:-:_next_to arg_node:-:A arg_node:-:B add_entity_node:-:california:=:state arg_node:-:B end_operation:-:arg ope_for:-:A return:-:A
what is the population of montana ?	add_node:-:B add_node:-:A add_edge:-:_population arg_node:-:B arg_node:-:A add_entity_node:-:montana:=:state arg_node:-:B return:-:A
what are the populations of all the major cities in montana ?	add_node:-:B add_node:-:A add_edge:-:_population arg_node:-:B arg_node:-:A add_type_node:-:_major arg_node:-:B add_type_node:-:_city arg_node:-:B add_node:-:C add_edge:-:_loc arg_node:-:B arg_node:-:C add_entity_node:-:montana:=:state arg_node:-:C return:-:A
which rivers run through the state with the lowest elevation in the usa ?	add_node:-:A add_type_node:-:_river arg_node:-:A add_node:-:B add_edge:-:_traverse arg_node:-:A arg_node:-:B add_type_node:-:_state arg_node:-:B add_node:-:C add_edge:-:_loc arg_node:-:C arg_node:-:B add_operation:-:_lowest add_type_node:-:_place arg_node:-:C add_node:-:D add_edge:-:_loc arg_node:-:C arg_node:-:D add_entity_node:-:usa:=:country arg_node:-:D end_operation:-:arg ope_for:-:C return:-:A
what rivers flow through the largest state ?	add_node:-:A add_type_node:-:_river arg_node:-:A add_node:-:B add_edge:-:_traverse arg_node:-:A arg_node:-:B add_operation:-:_largest add_type_node:-:_state arg_node:-:B end_operation:-:arg ope_for:-:B return:-:A
what is the area of maine ?	add_node:-:B add_node:-:A add_edge:-:_area arg_node:-:B arg_node:-:A add_entity_node:-:maine:=:state arg_node:-:B return:-:A
what are major rivers in texas ?	add_node:-:A add_type_node:-:_major arg_node:-:A add_type_node:-:_river arg_node:-:A add_node:-:B add_edge:-:_loc arg_node:-:A arg_node:-:B add_entity_node:-:texas:=:state arg_node:-:B return:-:A
what is the population density of the state with the smallest population ?	add_node:-:B add_node:-:A add_edge:-:_density arg_node:-:B arg_node:-:A add_operation:-:_smallest add_type_node:-:_state arg_node:-:B add_node:-:C add_edge:-:_population arg_node:-:B arg_node:-:C end_operation:-:arg ope_for:-:C return:-:A
what is the highest point in wyoming ?	add_operation:-:_highest add_node:-:A add_type_node:-:_place arg_node:-:A add_node:-:B add_edge:-:_loc arg_node:-:A arg_node:-:B add_entity_node:-:wyoming:=:state arg_node:-:B end_operation:-:arg ope_for:-:A return:-:A
what states border delaware ?	add_node:-:A add_type_node:-:_state arg_node:-:A add_node:-:B add_edge:-:_next_to arg_node:-:A arg_node:-:B add_entity_node:-:delaware:=:state arg_node:-:B return:-:A
which state has the most rivers running through it ?	add_operation:-:_most add_node:-:A add_type_node:-:_state arg_node:-:A add_node:-:B add_edge:-:_loc arg_node:-:B arg_node:-:A add_type_node:-:_river arg_node:-:B add_edge:-:_traverse arg_node:-:B arg_node:-:A end_operation:-:arg_count ope_for:-:A ope_for:-:B return:-:A
what is largest capital ?	add_operation:-:_largest add_node:-:A add_type_node:-:_capital arg_node:-:A end_operation:-:arg ope_for:-:A return:-:A
what is the state with the largest population density ?	add_operation:-:_largest add_node:-:A add_type_node:-:_state arg_node:-:A add_node:-:B add_edge:-:_density arg_node:-:A arg_node:-:B end_operation:-:arg ope_for:-:B return:-:A
what states have towns named springfield ?	add_node:-:A add_type_node:-:_state arg_node:-:A add_node:-:B add_edge:-:_loc arg_node:-:B arg_node:-:A add_entity_node:-:springfield:=:city arg_node:-:B return:-:A
what is the smallest city in the largest state ?	add_operation:-:_smallest add_node:-:A add_type_node:-:_city arg_node:-:A add_node:-:B add_edge:-:_loc arg_node:-:A arg_node:-:B add_operation:-:_largest add_type_node:-:_state arg_node:-:B end_operation:-:arg ope_for:-:B end_operation:-:arg ope_for:-:A return:-:A
what mountains are in alaska ?	add_node:-:A add_type_node:-:_mountain arg_node:-:A add_node:-:B add_edge:-:_loc arg_node:-:A arg_node:-:B add_entity_node:-:alaska:=:state arg_node:-:B return:-:A
what rivers flow through colorado ?	add_node:-:A add_type_node:-:_river arg_node:-:A add_node:-:B add_edge:-:_traverse arg_node:-:A arg_node:-:B add_entity_node:-:colorado:=:state arg_node:-:B return:-:A
which state has the least population density ?	add_operation:-:_smallest add_node:-:A add_type_node:-:_state arg_node:-:A add_node:-:B add_edge:-:_density arg_node:-:A arg_node:-:B end_operation:-:arg ope_for:-:B return:-:A
how many inhabitants does montgomery have ?	add_node:-:B add_node:-:A add_edge:-:_population arg_node:-:B arg_node:-:A add_entity_node:-:montgomery:=:city arg_node:-:B return:-:A
what city has the largest population ?	add_operation:-:_largest add_node:-:A add_type_node:-:_city arg_node:-:A add_node:-:B add_edge:-:_population arg_node:-:A arg_node:-:B end_operation:-:arg ope_for:-:B return:-:A
what is the largest state ?	add_operation:-:_largest add_node:-:A add_type_node:-:_state arg_node:-:A end_operation:-:arg ope_for:-:A return:-:A
of the states washed by the mississippi river which has the lowest point ?	add_operation:-:_lowest add_node:-:A add_type_node:-:_state arg_node:-:A add_node:-:C add_edge:-:_traverse arg_node:-:C arg_node:-:A add_entity_node:-:mississippi:=:river arg_node:-:C add_node:-:B add_edge:-:_loc arg_node:-:B arg_node:-:A add_type_node:-:_place arg_node:-:B end_operation:-:arg ope_for:-:B return:-:A
what is the area of the state with the smallest population density ?	add_node:-:B add_node:-:A add_edge:-:_area arg_node:-:B arg_node:-:A add_operation:-:_smallest add_type_node:-:_state arg_node:-:B add_node:-:C add_edge:-:_density arg_node:-:B arg_node:-:C end_operation:-:arg ope_for:-:C return:-:A
which state contains most rivers ?	add_operation:-:_most add_node:-:A add_type_node:-:_state arg_node:-:A add_node:-:B add_edge:-:_loc arg_node:-:B arg_node:-:A add_type_node:-:_river arg_node:-:B end_operation:-:arg_count ope_for:-:A ope_for:-:B return:-:A
what is the longest river in mississippi ?	add_operation:-:_longest add_node:-:A add_type_node:-:_river arg_node:-:A add_node:-:B add_edge:-:_loc arg_node:-:A arg_node:-:B add_entity_node:-:mississippi:=:state arg_node:-:B end_operation:-:arg ope_for:-:A return:-:A
what is the capital of the largest state ?	add_node:-:A add_type_node:-:_capital arg_node:-:A add_node:-:B add_edge:-:_loc arg_node:-:A arg_node:-:B add_operation:-:_largest add_type_node:-:_state arg_node:-:B end_operation:-:arg ope_for:-:B return:-:A
what state has the largest population ?	add_operation:-:_largest add_node:-:A add_type_node:-:_state arg_node:-:A add_node:-:B add_edge:-:_population arg_node:-:A arg_node:-:B end_operation:-:arg ope_for:-:B return:-:A
name the rivers in arkansas ?	add_node:-:A add_type_node:-:_river arg_node:-:A add_node:-:B add_edge:-:_loc arg_node:-:A arg_node:-:B add_entity_node:-:arkansas:=:state arg_node:-:B return:-:A
what are the populations of states through which the mississippi run ?	add_node:-:B add_node:-:A add_edge:-:_population arg_node:-:B arg_node:-:A add_type_node:-:_state arg_node:-:B add_node:-:C add_edge:-:_traverse arg_node:-:C arg_node:-:B add_entity_node:-:mississippi:=:river arg_node:-:C return:-:A
what is the population of arizona ?	add_node:-:B add_node:-:A add_edge:-:_population arg_node:-:B arg_node:-:A add_entity_node:-:arizona:=:state arg_node:-:B return:-:A
what state borders the state with the smallest population ?	add_node:-:A add_type_node:-:_state arg_node:-:A add_node:-:B add_edge:-:_next_to arg_node:-:A arg_node:-:B add_operation:-:_smallest add_type_node:-:_state arg_node:-:B add_node:-:C add_edge:-:_population arg_node:-:B arg_node:-:C end_operation:-:arg ope_for:-:C return:-:A
what is the total area of the usa ?	add_node:-:B add_node:-:A add_edge:-:_area arg_node:-:B arg_node:-:A add_entity_node:-:usa:=:country arg_node:-:B return:-:A
what is the population of seattle washington ?	add_node:-:B add_node:-:A add_edge:-:_population arg_node:-:B arg_node:-:A add_entity_node:-:seattle_wa:=:city arg_node:-:B return:-:A
what is the size of the largest state in the usa ?	add_node:-:B add_node:-:A add_edge:-:_size arg_node:-:B arg_node:-:A add_operation:-:_largest add_type_node:-:_state arg_node:-:B add_node:-:C add_edge:-:_loc arg_node:-:B arg_node:-:C add_entity_node:-:usa:=:country arg_node:-:C end_operation:-:arg ope_for:-:B return:-:A
what state has the capital salem ?	add_node:-:A add_type_node:-:_state arg_node:-:A add_node:-:B add_edge:-:_loc arg_node:-:B arg_node:-:A add_type_node:-:_capital arg_node:-:B add_entity_node:-:salem:=:city arg_node:-:B return:-:A
which is the lowest point of the states that the mississippi runs through ?	add_operation:-:_lowest add_node:-:B add_type_node:-:_place arg_node:-:B add_node:-:A add_edge:-:_loc arg_node:-:B arg_node:-:A add_type_node:-:_state arg_node:-:A add_node:-:C add_edge:-:_traverse arg_node:-:C arg_node:-:A add_entity_node:-:mississippi:=:river arg_node:-:C end_operation:-:arg ope_for:-:B return:-:B
how many major cities are in texas ?	add_operation:-:_count add_node:-:B add_type_node:-:_major arg_node:-:B add_type_node:-:_city arg_node:-:B add_node:-:C add_edge:-:_loc arg_node:-:B arg_node:-:C add_entity_node:-:texas:=:state arg_node:-:C end_operation:-:_count ope_for:-:B ope_return:-:A return:-:A
what is the capital city of the largest state in the us ?	add_node:-:A add_type_node:-:_capital arg_node:-:A add_type_node:-:_city arg_node:-:A add_node:-:B add_edge:-:_loc arg_node:-:A arg_node:-:B add_operation:-:_largest add_type_node:-:_state arg_node:-:B add_node:-:C add_edge:-:_loc arg_node:-:B arg_node:-:C add_entity_node:-:usa:=:country arg_node:-:C end_operation:-:arg ope_for:-:B return:-:A
what are the major cities in rhode island ?	add_node:-:A add_type_node:-:_major arg_node:-:A add_type_node:-:_city arg_node:-:A add_node:-:B add_edge:-:_loc arg_node:-:A arg_node:-:B add_entity_node:-:rhode_island:=:state arg_node:-:B return:-:A
what state has the most people ?	add_operation:-:_largest add_node:-:A add_type_node:-:_state arg_node:-:A add_node:-:B add_edge:-:_population arg_node:-:A arg_node:-:B end_operation:-:arg ope_for:-:B return:-:A
what is the largest city of kansas ?	add_operation:-:_largest add_node:-:A add_type_node:-:_city arg_node:-:A add_node:-:B add_edge:-:_loc arg_node:-:A arg_node:-:B add_entity_node:-:kansas:=:state arg_node:-:B end_operation:-:arg ope_for:-:A return:-:A
what is the area of the state with the capital albany ?	add_node:-:B add_node:-:A add_edge:-:_area arg_node:-:B arg_node:-:A add_type_node:-:_state arg_node:-:B add_node:-:C add_edge:-:_loc arg_node:-:C arg_node:-:B add_type_node:-:_capital arg_node:-:C add_entity_node:-:albany:=:city arg_node:-:C return:-:A
what is the longest river that flows through colorado ?	add_operation:-:_longest add_node:-:A add_type_node:-:_river arg_node:-:A add_node:-:B add_edge:-:_traverse arg_node:-:A arg_node:-:B add_entity_node:-:colorado:=:state arg_node:-:B end_operation:-:arg ope_for:-:A return:-:A
how many rivers does alaska have ?	add_operation:-:_count add_node:-:B add_type_node:-:_river arg_node:-:B add_node:-:C add_edge:-:_loc arg_node:-:B arg_node:-:C add_entity_node:-:alaska:=:state arg_node:-:C end_operation:-:_count ope_for:-:B ope_return:-:A return:-:A
how big is massachusetts ?	add_node:-:B add_node:-:A add_edge:-:_size arg_node:-:B arg_node:-:A add_entity_node:-:massachusetts:=:state arg_node:-:B return:-:A
how large is the largest city in alaska ?	add_node:-:B add_node:-:A add_edge:-:_size arg_node:-:B arg_node:-:A add_operation:-:_largest add_type_node:-:_city arg_node:-:B add_node:-:C add_edge:-:_loc arg_node:-:B arg_node:-:C add_entity_node:-:alaska:=:state arg_node:-:C end_operation:-:arg ope_for:-:B return:-:A
how many cities are there in usa ?	add_operation:-:_count add_node:-:B add_type_node:-:_city arg_node:-:B add_node:-:C add_edge:-:_loc arg_node:-:B arg_node:-:C add_entity_node:-:usa:=:country arg_node:-:C end_operation:-:_count ope_for:-:B ope_return:-:A return:-:A
what states capital is dover ?	add_node:-:A add_type_node:-:_state arg_node:-:A add_node:-:B add_edge:-:_capital arg_node:-:A arg_node:-:B add_entity_node:-:dover:=:city arg_node:-:B return:-:A
what states border new hampshire ?	add_node:-:A add_type_node:-:_state arg_node:-:A add_node:-:B add_edge:-:_next_to arg_node:-:A arg_node:-:B add_entity_node:-:new_hampshire:=:state arg_node:-:B return:-:A
what is the shortest river in nebraska ?	add_operation:-:_shortest add_node:-:A add_type_node:-:_river arg_node:-:A add_node:-:B add_edge:-:_loc arg_node:-:A arg_node:-:B add_entity_node:-:nebraska:=:state arg_node:-:B end_operation:-:arg ope_for:-:A return:-:A
how many states border hawaii ?	add_operation:-:_count add_node:-:B add_type_node:-:_state arg_node:-:B add_node:-:C add_edge:-:_next_to arg_node:-:B arg_node:-:C add_entity_node:-:hawaii:=:state arg_node:-:C end_operation:-:_count ope_for:-:B ope_return:-:A return:-:A
what state is dallas in ?	add_node:-:A add_type_node:-:_state arg_node:-:A add_node:-:B add_edge:-:_loc arg_node:-:B arg_node:-:A add_entity_node:-:dallas:=:city arg_node:-:B return:-:A
what city has the least population ?	add_operation:-:_smallest add_node:-:A add_type_node:-:_city arg_node:-:A add_node:-:B add_edge:-:_population arg_node:-:A arg_node:-:B end_operation:-:arg ope_for:-:B return:-:A
how many people stay in utah ?	add_node:-:B add_node:-:A add_edge:-:_population arg_node:-:B arg_node:-:A add_entity_node:-:utah:=:state arg_node:-:B return:-:A
what state has the sparsest population density ?	add_operation:-:_smallest add_node:-:A add_type_node:-:_state arg_node:-:A add_node:-:B add_edge:-:_density arg_node:-:A arg_node:-:B end_operation:-:arg ope_for:-:B return:-:A
what is the largest state that borders the state with the lowest point in the usa ?	add_operation:-:_largest add_node:-:A add_type_node:-:_state arg_node:-:A add_node:-:B add_edge:-:_next_to arg_node:-:A arg_node:-:B add_type_node:-:_state arg_node:-:B add_node:-:C add_edge:-:_loc arg_node:-:C arg_node:-:B add_operation:-:_lowest add_type_node:-:_place arg_node:-:C add_node:-:D add_edge:-:_loc arg_node:-:C arg_node:-:D add_entity_node:-:usa:=:country arg_node:-:D end_operation:-:arg ope_for:-:C end_operation:-:arg ope_for:-:A return:-:A
what is the largest city in texas ?	add_operation:-:_largest add_node:-:A add_type_node:-:_city arg_node:-:A add_node:-:B add_edge:-:_loc arg_node:-:A arg_node:-:B add_entity_node:-:texas:=:state arg_node:-:B end_operation:-:arg ope_for:-:A return:-:A
what is the largest state in the us ?	add_operation:-:_largest add_node:-:A add_type_node:-:_state arg_node:-:A add_node:-:B add_edge:-:_loc arg_node:-:A arg_node:-:B add_entity_node:-:usa:=:country arg_node:-:B end_operation:-:arg ope_for:-:A return:-:A
which state has the most people ?	add_operation:-:_largest add_node:-:A add_type_node:-:_state arg_node:-:A add_node:-:B add_edge:-:_population arg_node:-:A arg_node:-:B end_operation:-:arg ope_for:-:B return:-:A
what rivers are in new mexico ?	add_node:-:A add_type_node:-:_river arg_node:-:A add_node:-:B add_edge:-:_loc arg_node:-:A arg_node:-:B add_entity_node:-:new_mexico:=:state arg_node:-:B return:-:A
what is the area of maryland in square kilometers ?	add_node:-:B add_node:-:A add_edge:-:_area arg_node:-:B arg_node:-:A add_entity_node:-:maryland:=:state arg_node:-:B return:-:A
how many states are there in united states ?	add_operation:-:_count add_node:-:B add_type_node:-:_state arg_node:-:B add_node:-:C add_edge:-:_loc arg_node:-:B arg_node:-:C add_entity_node:-:usa:=:country arg_node:-:C end_operation:-:_count ope_for:-:B ope_return:-:A return:-:A
how many major cities are in states bordering nebraska ?	add_operation:-:_count add_node:-:B add_type_node:-:_major arg_node:-:B add_type_node:-:_city arg_node:-:B add_node:-:C add_edge:-:_loc arg_node:-:B arg_node:-:C add_type_node:-:_state arg_node:-:C add_node:-:D add_edge:-:_next_to arg_node:-:C arg_node:-:D add_entity_node:-:nebraska:=:state arg_node:-:D end_operation:-:_count ope_for:-:B ope_return:-:A return:-:A
what is the population of the largest state ?	add_node:-:B add_node:-:A add_edge:-:_population arg_node:-:B arg_node:-:A add_operation:-:_largest add_type_node:-:_state arg_node:-:B end_operation:-:arg ope_for:-:B return:-:A
what is the size of florida ?	add_node:-:B add_node:-:A add_edge:-:_size arg_node:-:B arg_node:-:A add_entity_node:-:florida:=:state arg_node:-:B return:-:A
how many rivers are in missouri ?	add_operation:-:_count add_node:-:B add_type_node:-:_river arg_node:-:B add_node:-:C add_edge:-:_loc arg_node:-:B arg_node:-:C add_entity_node:-:missouri:=:state arg_node:-:C end_operation:-:_count ope_for:-:B ope_return:-:A return:-:A
how many rivers are there in texas ?	add_operation:-:_count add_node:-:B add_type_node:-:_river arg_node:-:B add_node:-:C add_edge:-:_loc arg_node:-:B arg_node:-:C add_entity_node:-:texas:=:state arg_node:-:C end_operation:-:_count ope_for:-:B ope_return:-:A return:-:A
what is the highest point in the state with the capital des moines ?	add_operation:-:_highest add_node:-:A add_type_node:-:_place arg_node:-:A add_node:-:B add_edge:-:_loc arg_node:-:A arg_node:-:B add_type_node:-:_state arg_node:-:B add_node:-:C add_edge:-:_loc arg_node:-:C arg_node:-:B add_type_node:-:_capital arg_node:-:C add_entity_node:-:des_moines:=:city arg_node:-:C end_operation:-:arg ope_for:-:A return:-:A
what is the population of seattle ?	add_node:-:B add_node:-:A add_edge:-:_population arg_node:-:B arg_node:-:A add_entity_node:-:seattle:=:city arg_node:-:B return:-:A
what is the highest point in colorado ?	add_operation:-:_highest add_node:-:A add_type_node:-:_place arg_node:-:A add_node:-:B add_edge:-:_loc arg_node:-:A arg_node:-:B add_entity_node:-:colorado:=:state arg_node:-:B end_operation:-:arg ope_for:-:A return:-:A
which states border arizona ?	add_node:-:A add_type_node:-:_state arg_node:-:A add_node:-:B add_edge:-:_next_to arg_node:-:A arg_node:-:B add_entity_node:-:arizona:=:state arg_node:-:B return:-:A
what rivers run through the state with the lowest point in the usa ?	add_node:-:A add_type_node:-:_river arg_node:-:A add_node:-:B add_edge:-:_traverse arg_node:-:A arg_node:-:B add_type_node:-:_state arg_node:-:B add_node:-:C add_edge:-:_loc arg_node:-:C arg_node:-:B add_operation:-:_lowest add_type_node:-:_place arg_node:-:C add_node:-:D add_edge:-:_loc arg_node:-:C arg_node:-:D add_entity_node:-:usa:=:country arg_node:-:D end_operation:-:arg ope_for:-:C return:-:A
what is the population of minnesota ?	add_node:-:B add_node:-:A add_edge:-:_population arg_node:-:B arg_node:-:A add_entity_node:-:minnesota:=:state arg_node:-:B return:-:A
what state has the city with the most population ?	add_node:-:A add_type_node:-:_state arg_node:-:A add_node:-:B add_edge:-:_loc arg_node:-:B arg_node:-:A add_operation:-:_largest add_type_node:-:_city arg_node:-:B add_node:-:C add_edge:-:_population arg_node:-:B arg_node:-:C end_operation:-:arg ope_for:-:C return:-:A
which states have a major city named austin ?	add_node:-:A add_type_node:-:_state arg_node:-:A add_node:-:B add_edge:-:_loc arg_node:-:B arg_node:-:A add_type_node:-:_major arg_node:-:B add_type_node:-:_city arg_node:-:B add_entity_node:-:austin:=:city arg_node:-:B return:-:A
which states have points higher than the highest point in colorado ?	add_node:-:A add_type_node:-:_state arg_node:-:A add_node:-:B add_edge:-:_loc arg_node:-:B arg_node:-:A add_type_node:-:_place arg_node:-:B add_node:-:C add_edge:-:_higher arg_node:-:B arg_node:-:C add_operation:-:_highest add_type_node:-:_place arg_node:-:C add_node:-:D add_edge:-:_loc arg_node:-:C arg_node:-:D add_entity_node:-:colorado:=:state arg_node:-:D end_operation:-:arg ope_for:-:C return:-:A
what is the highest point in the state with the smallest population ?	add_operation:-:_highest add_node:-:A add_type_node:-:_place arg_node:-:A add_node:-:B add_edge:-:_loc arg_node:-:A arg_node:-:B add_operation:-:_smallest add_type_node:-:_state arg_node:-:B add_node:-:C add_edge:-:_population arg_node:-:B arg_node:-:C end_operation:-:arg ope_for:-:C end_operation:-:arg ope_for:-:A return:-:A
where is new hampshire ?	add_node:-:B add_node:-:A add_edge:-:_loc arg_node:-:B arg_node:-:A add_entity_node:-:new_hampshire:=:state arg_node:-:B return:-:A
which state borders florida ?	add_node:-:A add_type_node:-:_state arg_node:-:A add_node:-:B add_edge:-:_next_to arg_node:-:A arg_node:-:B add_entity_node:-:florida:=:state arg_node:-:B return:-:A
how many rivers in texas are longer than the red ?	add_operation:-:_count add_node:-:B add_type_node:-:_river arg_node:-:B add_node:-:C add_edge:-:_loc arg_node:-:B arg_node:-:C add_entity_node:-:texas:=:state arg_node:-:C add_node:-:D add_edge:-:_longer arg_node:-:B arg_node:-:D add_entity_node:-:red:=:river arg_node:-:D end_operation:-:_count ope_for:-:B ope_return:-:A return:-:A
how many rivers do not traverse the state with the capital albany ?	add_operation:-:_count add_node:-:B add_type_node:-:_river arg_node:-:B add_operation:-:_not add_node:-:C add_edge:-:_traverse arg_node:-:B arg_node:-:C add_type_node:-:_state arg_node:-:C add_node:-:D add_edge:-:_loc arg_node:-:D arg_node:-:C add_type_node:-:_capital arg_node:-:D add_entity_node:-:albany:=:city arg_node:-:D end_operation:-:_not end_operation:-:_count ope_for:-:B ope_return:-:A return:-:A
what are the populations of the states through which the mississippi run ?	add_node:-:B add_node:-:A add_edge:-:_population arg_node:-:B arg_node:-:A add_type_node:-:_state arg_node:-:B add_node:-:C add_edge:-:_traverse arg_node:-:C arg_node:-:B add_entity_node:-:mississippi:=:river arg_node:-:C return:-:A
through which states does the mississippi run ?	add_node:-:A add_type_node:-:_state arg_node:-:A add_node:-:B add_edge:-:_traverse arg_node:-:B arg_node:-:A add_entity_node:-:mississippi:=:river arg_node:-:B return:-:A
what states are next to the mississippi ?	add_node:-:A add_type_node:-:_state arg_node:-:A add_node:-:B add_edge:-:_next_to arg_node:-:A arg_node:-:B add_entity_node:-:mississippi:=:state arg_node:-:B return:-:A
give me the cities in virginia ?	add_node:-:A add_type_node:-:_city arg_node:-:A add_node:-:B add_edge:-:_loc arg_node:-:A arg_node:-:B add_entity_node:-:virginia:=:state arg_node:-:B return:-:A
what are the capital cities of the states which border texas ?	add_node:-:A add_type_node:-:_capital arg_node:-:A add_type_node:-:_city arg_node:-:A add_node:-:B add_edge:-:_loc arg_node:-:A arg_node:-:B add_type_node:-:_state arg_node:-:B add_node:-:C add_edge:-:_next_to arg_node:-:B arg_node:-:C add_entity_node:-:texas:=:state arg_node:-:C return:-:A
what state that borders texas has the highest population ?	add_operation:-:_largest add_node:-:A add_type_node:-:_state arg_node:-:A add_node:-:C add_edge:-:_next_to arg_node:-:A arg_node:-:C add_entity_node:-:texas:=:state arg_node:-:C add_node:-:B add_edge:-:_population arg_node:-:A arg_node:-:B end_operation:-:arg ope_for:-:B return:-:A
what state is the state with the most rivers ?	add_node:-:A add_type_node:-:_state arg_node:-:A add_operation:-:_most add_type_node:-:_state arg_node:-:A add_node:-:B add_edge:-:_loc arg_node:-:B arg_node:-:A add_type_node:-:_river arg_node:-:B end_operation:-:arg_count ope_for:-:A ope_for:-:B return:-:A
what state has the least population density ?	add_operation:-:_smallest add_node:-:A add_type_node:-:_state arg_node:-:A add_node:-:B add_edge:-:_density arg_node:-:A arg_node:-:B end_operation:-:arg ope_for:-:B return:-:A
what are the major cities in ohio ?	add_node:-:A add_type_node:-:_major arg_node:-:A add_type_node:-:_city arg_node:-:A add_node:-:B add_edge:-:_loc arg_node:-:A arg_node:-:B add_entity_node:-:ohio:=:state arg_node:-:B return:-:A
which states does the missouri river run through ?	add_node:-:A add_type_node:-:_state arg_node:-:A add_node:-:B add_edge:-:_traverse arg_node:-:B arg_node:-:A add_entity_node:-:missouri:=:river arg_node:-:B add_type_node:-:_river arg_node:-:B return:-:A
what is the biggest city in arizona ?	add_operation:-:_largest add_node:-:A add_type_node:-:_city arg_node:-:A add_node:-:B add_edge:-:_loc arg_node:-:A arg_node:-:B add_entity_node:-:arizona:=:state arg_node:-:B end_operation:-:arg ope_for:-:A return:-:A
how many people live in hawaii ?	add_node:-:B add_node:-:A add_edge:-:_population arg_node:-:B arg_node:-:A add_entity_node:-:hawaii:=:state arg_node:-:B return:-:A
how many people live in the smallest state bordering wyoming ?	add_node:-:B add_node:-:A add_edge:-:_population arg_node:-:B arg_node:-:A add_operation:-:_smallest add_type_node:-:_state arg_node:-:B add_node:-:C add_edge:-:_next_to arg_node:-:B arg_node:-:C add_entity_node:-:wyoming:=:state arg_node:-:C end_operation:-:arg ope_for:-:B return:-:A
what is the name of the state with the lowest point ?	add_node:-:A add_type_node:-:_state arg_node:-:A add_node:-:B add_edge:-:_loc arg_node:-:B arg_node:-:A add_operation:-:_lowest add_type_node:-:_place arg_node:-:B end_operation:-:arg ope_for:-:B return:-:A
what rivers flow through missouri ?	add_node:-:A add_type_node:-:_river arg_node:-:A add_node:-:B add_edge:-:_traverse arg_node:-:A arg_node:-:B add_entity_node:-:missouri:=:state arg_node:-:B return:-:A
what is the elevation of death valley ?	add_node:-:B add_node:-:A add_edge:-:_elevation arg_node:-:B arg_node:-:A add_entity_node:-:death_valley:=:place arg_node:-:B return:-:A
what river flows through texas ?	add_node:-:A add_type_node:-:_river arg_node:-:A add_node:-:B add_edge:-:_traverse arg_node:-:A arg_node:-:B add_entity_node:-:texas:=:state arg_node:-:B return:-:A
how high are the highest points of all the states ?	add_node:-:B add_node:-:A add_edge:-:_elevation arg_node:-:B arg_node:-:A add_operation:-:_highest add_type_node:-:_place arg_node:-:B add_node:-:C add_edge:-:_loc arg_node:-:B arg_node:-:C add_type_node:-:_state arg_node:-:C end_operation:-:arg ope_for:-:B return:-:A
what is the capital of new hampshire ?	add_node:-:A add_type_node:-:_capital arg_node:-:A add_node:-:B add_edge:-:_loc arg_node:-:A arg_node:-:B add_entity_node:-:new_hampshire:=:state arg_node:-:B return:-:A
how long is the rio grande river ?	add_node:-:B add_node:-:A add_edge:-:_len arg_node:-:B arg_node:-:A add_entity_node:-:rio_grande:=:river arg_node:-:B add_type_node:-:_river arg_node:-:B return:-:A
which state borders most states ?	add_operation:-:_most add_node:-:A add_type_node:-:_state arg_node:-:A add_node:-:B add_edge:-:_next_to arg_node:-:A arg_node:-:B add_type_node:-:_state arg_node:-:B end_operation:-:arg_count ope_for:-:A ope_for:-:B return:-:A
how many states does missouri border ?	add_operation:-:_count add_node:-:B add_type_node:-:_state arg_node:-:B add_node:-:C add_edge:-:_next_to arg_node:-:C arg_node:-:B add_entity_node:-:missouri:=:state arg_node:-:C end_operation:-:_count ope_for:-:B ope_return:-:A return:-:A
where is austin ?	add_node:-:B add_node:-:A add_edge:-:_loc arg_node:-:B arg_node:-:A add_entity_node:-:austin:=:city arg_node:-:B return:-:A
how high is the highest point of delaware ?	add_node:-:B add_node:-:A add_edge:-:_elevation arg_node:-:B arg_node:-:A add_operation:-:_highest add_type_node:-:_place arg_node:-:B add_node:-:C add_edge:-:_loc arg_node:-:B arg_node:-:C add_entity_node:-:delaware:=:state arg_node:-:C end_operation:-:arg ope_for:-:B return:-:A
where is the highest point in montana ?	add_operation:-:_highest add_node:-:A add_type_node:-:_place arg_node:-:A add_node:-:B add_edge:-:_loc arg_node:-:A arg_node:-:B add_entity_node:-:montana:=:state arg_node:-:B end_operation:-:arg ope_for:-:A return:-:A
what states border states that border the state with the largest population ?	add_node:-:A add_type_node:-:_state arg_node:-:A add_node:-:B add_edge:-:_next_to arg_node:-:A arg_node:-:B add_type_node:-:_state arg_node:-:B add_node:-:C add_edge:-:_next_to arg_node:-:B arg_node:-:C add_operation:-:_largest add_type_node:-:_state arg_node:-:C add_node:-:D add_edge:-:_population arg_node:-:C arg_node:-:D end_operation:-:arg ope_for:-:D return:-:A
what is the height of the highest mountain in texas ?	add_node:-:B add_node:-:A add_edge:-:_elevation arg_node:-:B arg_node:-:A add_operation:-:_highest add_type_node:-:_mountain arg_node:-:B add_node:-:C add_edge:-:_loc arg_node:-:B arg_node:-:C add_entity_node:-:texas:=:state arg_node:-:C end_operation:-:arg ope_for:-:B return:-:A
what state has the city flint ?	add_node:-:A add_type_node:-:_state arg_node:-:A add_node:-:B add_edge:-:_loc arg_node:-:B arg_node:-:A add_type_node:-:_city arg_node:-:B add_entity_node:-:flint:=:city arg_node:-:B return:-:A
what is the state with the largest density in usa ?	add_operation:-:_largest add_node:-:A add_type_node:-:_state arg_node:-:A add_node:-:B add_edge:-:_density arg_node:-:A arg_node:-:B add_node:-:C add_edge:-:_loc arg_node:-:A arg_node:-:C add_entity_node:-:usa:=:country arg_node:-:C end_operation:-:arg ope_for:-:B return:-:A
what cities in texas have the highest number of citizens ?	add_operation:-:_largest add_node:-:A add_type_node:-:_city arg_node:-:A add_node:-:C add_edge:-:_loc arg_node:-:A arg_node:-:C add_entity_node:-:texas:=:state arg_node:-:C add_node:-:B add_edge:-:_population arg_node:-:A arg_node:-:B end_operation:-:arg ope_for:-:B return:-:A
what states border missouri ?	add_node:-:A add_type_node:-:_state arg_node:-:A add_node:-:B add_edge:-:_next_to arg_node:-:A arg_node:-:B add_entity_node:-:missouri:=:state arg_node:-:B return:-:A
give me the largest state ?	add_operation:-:_largest add_node:-:A add_type_node:-:_state arg_node:-:A end_operation:-:arg ope_for:-:A return:-:A
which state has the sparsest population density ?	add_operation:-:_smallest add_node:-:A add_type_node:-:_state arg_node:-:A add_node:-:B add_edge:-:_density arg_node:-:A arg_node:-:B end_operation:-:arg ope_for:-:B return:-:A
which states border alabama ?	add_node:-:A add_type_node:-:_state arg_node:-:A add_node:-:B add_edge:-:_next_to arg_node:-:A arg_node:-:B add_entity_node:-:alabama:=:state arg_node:-:B return:-:A
what rivers flow through states that alabama borders ?	add_node:-:A add_type_node:-:_river arg_node:-:A add_node:-:B add_edge:-:_traverse arg_node:-:A arg_node:-:B add_type_node:-:_state arg_node:-:B add_node:-:C add_edge:-:_next_to arg_node:-:C arg_node:-:B add_entity_node:-:alabama:=:state arg_node:-:C return:-:A
what are the major cities in wyoming ?	add_node:-:A add_type_node:-:_major arg_node:-:A add_type_node:-:_city arg_node:-:A add_node:-:B add_edge:-:_loc arg_node:-:A arg_node:-:B add_entity_node:-:wyoming:=:state arg_node:-:B return:-:A
what are the highest points of states surrounding mississippi ?	add_operation:-:_highest add_node:-:A add_type_node:-:_place arg_node:-:A add_node:-:B add_edge:-:_loc arg_node:-:A arg_node:-:B add_type_node:-:_state arg_node:-:B add_node:-:C add_edge:-:_next_to arg_node:-:B arg_node:-:C add_entity_node:-:mississippi:=:state arg_node:-:C end_operation:-:arg ope_for:-:A return:-:A
through which states does the mississippi flow ?	add_node:-:A add_type_node:-:_state arg_node:-:A add_node:-:B add_edge:-:_traverse arg_node:-:B arg_node:-:A add_entity_node:-:mississippi:=:river arg_node:-:B return:-:A
where is scotts valley ?	add_node:-:B add_node:-:A add_edge:-:_loc arg_node:-:B arg_node:-:A add_entity_node:-:scotts_valley:=:city arg_node:-:B return:-:A
what are the major lakes in united states ?	add_node:-:A add_type_node:-:_major arg_node:-:A add_type_node:-:_lake arg_node:-:A add_node:-:B add_edge:-:_loc arg_node:-:A arg_node:-:B add_entity_node:-:usa:=:country arg_node:-:B return:-:A
what is the largest city in missouri ?	add_operation:-:_largest add_node:-:A add_type_node:-:_city arg_node:-:A add_node:-:B add_edge:-:_loc arg_node:-:A arg_node:-:B add_entity_node:-:missouri:=:state arg_node:-:B end_operation:-:arg ope_for:-:A return:-:A
what states border alaska ?	add_node:-:A add_type_node:-:_state arg_node:-:A add_node:-:B add_edge:-:_next_to arg_node:-:A arg_node:-:B add_entity_node:-:alaska:=:state arg_node:-:B return:-:A
what state has the largest city ?	add_operation:-:_largest add_node:-:A add_type_node:-:_state arg_node:-:A add_node:-:B add_edge:-:_loc arg_node:-:B arg_node:-:A add_type_node:-:_city arg_node:-:B end_operation:-:arg ope_for:-:B return:-:A
what rivers run through maine ?	add_node:-:A add_type_node:-:_river arg_node:-:A add_node:-:B add_edge:-:_traverse arg_node:-:A arg_node:-:B add_entity_node:-:maine:=:state arg_node:-:B return:-:A
give me the lakes in california ?	add_node:-:A add_type_node:-:_lake arg_node:-:A add_node:-:B add_edge:-:_loc arg_node:-:A arg_node:-:B add_entity_node:-:california:=:state arg_node:-:B return:-:A
what is the combined population of all 50 states ?	add_operation:-:_sum add_node:-:C add_type_node:-:_state arg_node:-:C add_type_node:-:_population arg_node:-:C end_operation:-:_sum ope_for:-:C ope_in:-:_population ope_return:-:A return:-:A
how high is the highest point of louisiana ?	add_node:-:B add_node:-:A add_edge:-:_elevation arg_node:-:B arg_node:-:A add_operation:-:_highest add_type_node:-:_place arg_node:-:B add_node:-:C add_edge:-:_loc arg_node:-:B arg_node:-:C add_entity_node:-:louisiana:=:state arg_node:-:C end_operation:-:arg ope_for:-:B return:-:A
what is the longest river in pennsylvania ?	add_operation:-:_longest add_node:-:A add_type_node:-:_river arg_node:-:A add_node:-:B add_edge:-:_loc arg_node:-:A arg_node:-:B add_entity_node:-:pennsylvania:=:state arg_node:-:B end_operation:-:arg ope_for:-:A return:-:A
what is the capital of maryland ?	add_node:-:A add_type_node:-:_capital arg_node:-:A add_node:-:B add_edge:-:_loc arg_node:-:A arg_node:-:B add_entity_node:-:maryland:=:state arg_node:-:B return:-:A
what state is the biggest ?	add_operation:-:_largest add_node:-:A add_type_node:-:_state arg_node:-:A end_operation:-:arg ope_for:-:A return:-:A
which states border iowa ?	add_node:-:A add_type_node:-:_state arg_node:-:A add_node:-:B add_edge:-:_next_to arg_node:-:A arg_node:-:B add_entity_node:-:iowa:=:state arg_node:-:B return:-:A
which states border alaska ?	add_node:-:A add_type_node:-:_state arg_node:-:A add_node:-:B add_edge:-:_next_to arg_node:-:A arg_node:-:B add_entity_node:-:alaska:=:state arg_node:-:B return:-:A
what is the largest state in usa ?	add_operation:-:_largest add_node:-:A add_type_node:-:_state arg_node:-:A add_node:-:B add_edge:-:_loc arg_node:-:A arg_node:-:B add_entity_node:-:usa:=:country arg_node:-:B end_operation:-:arg ope_for:-:A return:-:A
what are the major cities in california ?	add_node:-:A add_type_node:-:_major arg_node:-:A add_type_node:-:_city arg_node:-:A add_node:-:B add_edge:-:_loc arg_node:-:A arg_node:-:B add_entity_node:-:california:=:state arg_node:-:B return:-:A
what is the largest state traversed by the mississippi river ?	add_operation:-:_largest add_node:-:A add_type_node:-:_state arg_node:-:A add_node:-:B add_edge:-:_traverse arg_node:-:B arg_node:-:A add_entity_node:-:mississippi:=:river arg_node:-:B end_operation:-:arg ope_for:-:A return:-:A
which rivers run through states bordering new mexico ?	add_node:-:A add_type_node:-:_river arg_node:-:A add_node:-:B add_edge:-:_traverse arg_node:-:A arg_node:-:B add_type_node:-:_state arg_node:-:B add_node:-:C add_edge:-:_next_to arg_node:-:B arg_node:-:C add_entity_node:-:new_mexico:=:state arg_node:-:C return:-:A
what is the lowest point in the state of texas ?	add_operation:-:_lowest add_node:-:A add_type_node:-:_place arg_node:-:A add_node:-:B add_edge:-:_loc arg_node:-:A arg_node:-:B add_type_node:-:_state arg_node:-:B add_entity_node:-:texas:=:state arg_node:-:B end_operation:-:arg ope_for:-:A return:-:A
what is the smallest state bordering ohio ?	add_operation:-:_smallest add_node:-:A add_type_node:-:_state arg_node:-:A add_node:-:B add_edge:-:_next_to arg_node:-:A arg_node:-:B add_entity_node:-:ohio:=:state arg_node:-:B end_operation:-:arg ope_for:-:A return:-:A
how many states are next to major rivers ?	add_operation:-:_count add_node:-:B add_type_node:-:_state arg_node:-:B add_node:-:C add_edge:-:_next_to arg_node:-:B arg_node:-:C add_type_node:-:_major arg_node:-:C add_type_node:-:_river arg_node:-:C end_operation:-:_count ope_for:-:B ope_return:-:A return:-:A
what is the lowest point of the us ?	add_operation:-:_lowest add_node:-:A add_type_node:-:_place arg_node:-:A add_node:-:B add_edge:-:_loc arg_node:-:A arg_node:-:B add_entity_node:-:usa:=:country arg_node:-:B end_operation:-:arg ope_for:-:A return:-:A
which state has the greatest density ?	add_operation:-:_largest add_node:-:A add_type_node:-:_state arg_node:-:A add_node:-:B add_edge:-:_density arg_node:-:A arg_node:-:B end_operation:-:arg ope_for:-:B return:-:A
how many states border the largest state ?	add_operation:-:_count add_node:-:B add_type_node:-:_state arg_node:-:B add_node:-:C add_edge:-:_next_to arg_node:-:B arg_node:-:C add_operation:-:_largest add_type_node:-:_state arg_node:-:C end_operation:-:arg ope_for:-:C end_operation:-:_count ope_for:-:B ope_return:-:A return:-:A
what is the longest river that does not run through texas ?	add_operation:-:_longest add_node:-:A add_type_node:-:_river arg_node:-:A add_operation:-:_not add_node:-:B add_edge:-:_traverse arg_node:-:A arg_node:-:B add_entity_node:-:texas:=:state arg_node:-:B end_operation:-:_not end_operation:-:arg ope_for:-:A return:-:A
give me all the states of usa ?	add_node:-:A add_type_node:-:_state arg_node:-:A add_node:-:B add_edge:-:_loc arg_node:-:A arg_node:-:B add_entity_node:-:usa:=:country arg_node:-:B return:-:A
what is the density of texas ?	add_node:-:B add_node:-:A add_edge:-:_density arg_node:-:B arg_node:-:A add_entity_node:-:texas:=:state arg_node:-:B return:-:A
what is the smallest city of the smallest state in the us ?	add_operation:-:_smallest add_node:-:A add_type_node:-:_city arg_node:-:A add_node:-:B add_edge:-:_loc arg_node:-:A arg_node:-:B add_operation:-:_smallest add_type_node:-:_state arg_node:-:B add_node:-:C add_edge:-:_loc arg_node:-:B arg_node:-:C add_entity_node:-:usa:=:country arg_node:-:C end_operation:-:arg ope_for:-:B end_operation:-:arg ope_for:-:A return:-:A
what is the highest point in kansas ?	add_operation:-:_highest add_node:-:A add_type_node:-:_place arg_node:-:A add_node:-:B add_edge:-:_loc arg_node:-:A arg_node:-:B add_entity_node:-:kansas:=:state arg_node:-:B end_operation:-:arg ope_for:-:A return:-:A
what is the population in boston ?	add_node:-:B add_node:-:A add_edge:-:_population arg_node:-:B arg_node:-:A add_entity_node:-:boston:=:city arg_node:-:B return:-:A
how many people are in the state of nevada ?	add_node:-:B add_node:-:A add_edge:-:_population arg_node:-:B arg_node:-:A add_entity_node:-:nevada:=:state arg_node:-:B return:-:A
what is the population density of texas ?	add_node:-:B add_node:-:A add_edge:-:_density arg_node:-:B arg_node:-:A add_entity_node:-:texas:=:state arg_node:-:B return:-:A
how many people live in washington dc ?	add_node:-:B add_node:-:A add_edge:-:_population arg_node:-:B arg_node:-:A add_entity_node:-:washington_dc:=:city arg_node:-:B return:-:A
give me the cities in texas ?	add_node:-:A add_type_node:-:_city arg_node:-:A add_node:-:B add_edge:-:_loc arg_node:-:A arg_node:-:B add_entity_node:-:texas:=:state arg_node:-:B return:-:A
how long is the shortest river in the usa ?	add_node:-:B add_node:-:A add_edge:-:_len arg_node:-:B arg_node:-:A add_operation:-:_shortest add_type_node:-:_river arg_node:-:B add_node:-:C add_edge:-:_loc arg_node:-:B arg_node:-:C add_entity_node:-:usa:=:country arg_node:-:C end_operation:-:arg ope_for:-:B return:-:A
how many states have major rivers ?	add_operation:-:_count add_node:-:B add_type_node:-:_state arg_node:-:B add_node:-:C add_edge:-:_loc arg_node:-:C arg_node:-:B add_type_node:-:_major arg_node:-:C add_type_node:-:_river arg_node:-:C end_operation:-:_count ope_for:-:B ope_return:-:A return:-:A
what is the population density of the smallest state ?	add_node:-:B add_node:-:A add_edge:-:_density arg_node:-:B arg_node:-:A add_operation:-:_smallest add_type_node:-:_state arg_node:-:B end_operation:-:arg ope_for:-:B return:-:A
which states border michigan ?	add_node:-:A add_type_node:-:_state arg_node:-:A add_node:-:B add_edge:-:_next_to arg_node:-:A arg_node:-:B add_entity_node:-:michigan:=:state arg_node:-:B return:-:A
what cities in texas have the highest populations ?	add_operation:-:_largest add_node:-:A add_type_node:-:_city arg_node:-:A add_node:-:C add_edge:-:_loc arg_node:-:A arg_node:-:C add_entity_node:-:texas:=:state arg_node:-:C add_node:-:B add_edge:-:_population arg_node:-:A arg_node:-:B end_operation:-:arg ope_for:-:B return:-:A
what rivers run through the states that border the state with the capital atlanta ?	add_node:-:A add_type_node:-:_river arg_node:-:A add_node:-:B add_edge:-:_traverse arg_node:-:A arg_node:-:B add_type_node:-:_state arg_node:-:B add_node:-:C add_edge:-:_next_to arg_node:-:B arg_node:-:C add_type_node:-:_state arg_node:-:C add_node:-:D add_edge:-:_loc arg_node:-:D arg_node:-:C add_type_node:-:_capital arg_node:-:D add_entity_node:-:atlanta:=:city arg_node:-:D return:-:A
what is the highest point in the country ?	add_operation:-:_highest add_node:-:A add_type_node:-:_place arg_node:-:A add_node:-:B add_edge:-:_loc arg_node:-:A arg_node:-:B add_entity_node:-:usa:=:country arg_node:-:B end_operation:-:arg ope_for:-:A return:-:A
how many people live in kalamazoo ?	add_node:-:B add_node:-:A add_edge:-:_population arg_node:-:B arg_node:-:A add_entity_node:-:kalamazoo:=:city arg_node:-:B return:-:A
how many major cities are in florida ?	add_operation:-:_count add_node:-:B add_type_node:-:_major arg_node:-:B add_type_node:-:_city arg_node:-:B add_node:-:C add_edge:-:_loc arg_node:-:B arg_node:-:C add_entity_node:-:florida:=:state arg_node:-:C end_operation:-:_count ope_for:-:B ope_return:-:A return:-:A
what state has the greatest population density ?	add_operation:-:_largest add_node:-:A add_type_node:-:_state arg_node:-:A add_node:-:B add_edge:-:_density arg_node:-:A arg_node:-:B end_operation:-:arg ope_for:-:B return:-:A
how many rivers are found in colorado ?	add_operation:-:_count add_node:-:B add_type_node:-:_river arg_node:-:B add_node:-:C add_edge:-:_loc arg_node:-:B arg_node:-:C add_entity_node:-:colorado:=:state arg_node:-:C end_operation:-:_count ope_for:-:B ope_return:-:A return:-:A
what is the lowest point of the state with the largest area ?	add_operation:-:_lowest add_node:-:A add_type_node:-:_place arg_node:-:A add_node:-:B add_edge:-:_loc arg_node:-:A arg_node:-:B add_operation:-:_largest add_type_node:-:_state arg_node:-:B add_node:-:C add_edge:-:_area arg_node:-:B arg_node:-:C end_operation:-:arg ope_for:-:C end_operation:-:arg ope_for:-:A return:-:A
what states border texas ?	add_node:-:A add_type_node:-:_state arg_node:-:A add_node:-:B add_edge:-:_next_to arg_node:-:A arg_node:-:B add_entity_node:-:texas:=:state arg_node:-:B return:-:A
how many states border at least one other state ?	add_operation:-:_count add_node:-:B add_type_node:-:_state arg_node:-:B add_node:-:C add_edge:-:_next_to arg_node:-:B arg_node:-:C add_type_node:-:_state arg_node:-:C end_operation:-:_count ope_for:-:B ope_return:-:A return:-:A
which states border no other states ?	add_node:-:A add_type_node:-:_state arg_node:-:A add_operation:-:_not add_node:-:B add_edge:-:_next_to arg_node:-:A arg_node:-:B add_type_node:-:_state arg_node:-:B end_operation:-:_not return:-:A
what rivers run through austin texas ?	add_node:-:A add_type_node:-:_river arg_node:-:A add_node:-:B add_edge:-:_traverse arg_node:-:A arg_node:-:B add_entity_node:-:austin_tx:=:city arg_node:-:B return:-:A
how many people live in new hampshire ?	add_node:-:B add_node:-:A add_edge:-:_population arg_node:-:B arg_node:-:A add_entity_node:-:new_hampshire:=:state arg_node:-:B return:-:A
what is the capital of indiana ?	add_node:-:A add_type_node:-:_capital arg_node:-:A add_node:-:B add_edge:-:_loc arg_node:-:A arg_node:-:B add_entity_node:-:indiana:=:state arg_node:-:B return:-:A
what states border the states with the most cities ?	add_node:-:A add_type_node:-:_state arg_node:-:A add_node:-:B add_edge:-:_next_to arg_node:-:A arg_node:-:B add_operation:-:_most add_type_node:-:_state arg_node:-:B add_node:-:C add_edge:-:_loc arg_node:-:C arg_node:-:B add_type_node:-:_city arg_node:-:C end_operation:-:arg_count ope_for:-:B ope_for:-:C return:-:A
what is the area of the smallest state ?	add_node:-:B add_node:-:A add_edge:-:_area arg_node:-:B arg_node:-:A add_operation:-:_smallest add_type_node:-:_state arg_node:-:B end_operation:-:arg ope_for:-:B return:-:A
which states border new york ?	add_node:-:A add_type_node:-:_state arg_node:-:A add_node:-:B add_edge:-:_next_to arg_node:-:A arg_node:-:B add_entity_node:-:new_york:=:state arg_node:-:B return:-:A
what is the population of maine ?	add_node:-:B add_node:-:A add_edge:-:_population arg_node:-:B arg_node:-:A add_entity_node:-:maine:=:state arg_node:-:B return:-:A
what is the biggest city in the smallest state ?	add_operation:-:_largest add_node:-:A add_type_node:-:_city arg_node:-:A add_node:-:B add_edge:-:_loc arg_node:-:A arg_node:-:B add_operation:-:_smallest add_type_node:-:_state arg_node:-:B end_operation:-:arg ope_for:-:B end_operation:-:arg ope_for:-:A return:-:A
what is the elevation of the highest point in the usa ?	add_node:-:B add_node:-:A add_edge:-:_elevation arg_node:-:B arg_node:-:A add_operation:-:_highest add_type_node:-:_place arg_node:-:B add_node:-:C add_edge:-:_loc arg_node:-:B arg_node:-:C add_entity_node:-:usa:=:country arg_node:-:C end_operation:-:arg ope_for:-:B return:-:A
what state borders the least states excluding alaska and excluding hawaii ?	add_operation:-:_fewest add_node:-:A add_type_node:-:_state arg_node:-:A add_node:-:B add_edge:-:_next_to arg_node:-:A arg_node:-:B add_type_node:-:_state arg_node:-:B add_operation:-:_not add_entity_node:-:hawaii:=:state arg_node:-:A end_operation:-:_not add_operation:-:_not add_entity_node:-:hawaii:=:state arg_node:-:A end_operation:-:_not end_operation:-:arg_count ope_for:-:A ope_for:-:B return:-:A
what is the highest point in new mexico ?	add_operation:-:_highest add_node:-:A add_type_node:-:_place arg_node:-:A add_node:-:B add_edge:-:_loc arg_node:-:A arg_node:-:B add_entity_node:-:new_mexico:=:state arg_node:-:B end_operation:-:arg ope_for:-:A return:-:A
what is the biggest state ?	add_operation:-:_largest add_node:-:A add_type_node:-:_state arg_node:-:A end_operation:-:arg ope_for:-:A return:-:A
how many people live in spokane washington ?	add_node:-:B add_node:-:A add_edge:-:_population arg_node:-:B arg_node:-:A add_entity_node:-:spokane_wa:=:city arg_node:-:B return:-:A
what states does the shortest river run through ?	add_node:-:A add_type_node:-:_state arg_node:-:A add_node:-:B add_edge:-:_traverse arg_node:-:B arg_node:-:A add_operation:-:_shortest add_type_node:-:_river arg_node:-:B end_operation:-:arg ope_for:-:B return:-:A
how long is rio grande ?	add_node:-:B add_node:-:A add_edge:-:_len arg_node:-:B arg_node:-:A add_entity_node:-:rio_grande:=:river arg_node:-:B return:-:A
how many people live in texas ?	add_node:-:B add_node:-:A add_edge:-:_population arg_node:-:B arg_node:-:A add_entity_node:-:texas:=:state arg_node:-:B return:-:A
where is the lowest spot in iowa ?	add_operation:-:_lowest add_node:-:A add_type_node:-:_place arg_node:-:A add_node:-:B add_edge:-:_loc arg_node:-:A arg_node:-:B add_entity_node:-:iowa:=:state arg_node:-:B end_operation:-:arg ope_for:-:A return:-:A
what are the populations of the states through which the mississippi river runs ?	add_node:-:B add_node:-:A add_edge:-:_population arg_node:-:B arg_node:-:A add_type_node:-:_state arg_node:-:B add_node:-:C add_edge:-:_traverse arg_node:-:C arg_node:-:B add_entity_node:-:mississippi:=:river arg_node:-:C add_type_node:-:_river arg_node:-:C return:-:A
what is the lowest point in oregon ?	add_operation:-:_lowest add_node:-:A add_type_node:-:_place arg_node:-:A add_node:-:B add_edge:-:_loc arg_node:-:A arg_node:-:B add_entity_node:-:oregon:=:state arg_node:-:B end_operation:-:arg ope_for:-:A return:-:A
what is the shortest river in alaska ?	add_operation:-:_shortest add_node:-:A add_type_node:-:_river arg_node:-:A add_node:-:B add_edge:-:_loc arg_node:-:A arg_node:-:B add_entity_node:-:alaska:=:state arg_node:-:B end_operation:-:arg ope_for:-:A return:-:A
how many states border the mississippi river ?	add_operation:-:_count add_node:-:B add_type_node:-:_state arg_node:-:B add_node:-:C add_edge:-:_next_to arg_node:-:B arg_node:-:C add_entity_node:-:mississippi:=:river arg_node:-:C add_type_node:-:_river arg_node:-:C end_operation:-:_count ope_for:-:B ope_return:-:A return:-:A
what is the most populated capital in the usa ?	add_operation:-:_largest add_node:-:A add_node:-:B add_edge:-:_population arg_node:-:A arg_node:-:B add_type_node:-:_capital arg_node:-:A add_node:-:C add_edge:-:_loc arg_node:-:A arg_node:-:C add_entity_node:-:usa:=:country arg_node:-:C end_operation:-:arg ope_for:-:B return:-:A
what is the highest point in ohio ?	add_operation:-:_highest add_node:-:A add_type_node:-:_place arg_node:-:A add_node:-:B add_edge:-:_loc arg_node:-:A arg_node:-:B add_entity_node:-:ohio:=:state arg_node:-:B end_operation:-:arg ope_for:-:A return:-:A
what states border wisconsin ?	add_node:-:A add_type_node:-:_state arg_node:-:A add_node:-:B add_edge:-:_next_to arg_node:-:A arg_node:-:B add_entity_node:-:wisconsin:=:state arg_node:-:B return:-:A
what states have a capital that is the highest point in the state ?	add_node:-:A add_type_node:-:_state arg_node:-:A add_node:-:B add_edge:-:_loc arg_node:-:B arg_node:-:A add_type_node:-:_capital arg_node:-:B add_edge:-:_high_point arg_node:-:A arg_node:-:B return:-:A
how many states border colorado and border new mexico ?	add_operation:-:_count add_node:-:B add_type_node:-:_state arg_node:-:B add_node:-:C add_edge:-:_next_to arg_node:-:B arg_node:-:C add_entity_node:-:colorado:=:state arg_node:-:C add_node:-:D add_edge:-:_next_to arg_node:-:B arg_node:-:D add_entity_node:-:new_mexico:=:state arg_node:-:D end_operation:-:_count ope_for:-:B ope_return:-:A return:-:A
what are the major cities in missouri ?	add_node:-:A add_type_node:-:_major arg_node:-:A add_type_node:-:_city arg_node:-:A add_node:-:B add_edge:-:_loc arg_node:-:A arg_node:-:B add_entity_node:-:missouri:=:state arg_node:-:B return:-:A
what are the major cities of texas ?	add_node:-:A add_type_node:-:_major arg_node:-:A add_type_node:-:_city arg_node:-:A add_node:-:B add_edge:-:_loc arg_node:-:A arg_node:-:B add_entity_node:-:texas:=:state arg_node:-:B return:-:A
how many rivers are called colorado ?	add_operation:-:_count add_node:-:B add_type_node:-:_river arg_node:-:B add_entity_node:-:colorado:=:river arg_node:-:B end_operation:-:_count ope_for:-:B ope_return:-:A return:-:A
how high is the highest point in montana ?	add_node:-:B add_node:-:A add_edge:-:_elevation arg_node:-:B arg_node:-:A add_operation:-:_highest add_type_node:-:_place arg_node:-:B add_node:-:C add_edge:-:_loc arg_node:-:B arg_node:-:C add_entity_node:-:montana:=:state arg_node:-:C end_operation:-:arg ope_for:-:B return:-:A
how many states have cities named austin ?	add_operation:-:_count add_node:-:B add_type_node:-:_state arg_node:-:B add_node:-:C add_edge:-:_loc arg_node:-:C arg_node:-:B add_type_node:-:_city arg_node:-:C add_entity_node:-:austin:=:city arg_node:-:C end_operation:-:_count ope_for:-:B ope_return:-:A return:-:A
which states does the missouri river pass through ?	add_node:-:A add_type_node:-:_state arg_node:-:A add_node:-:B add_edge:-:_traverse arg_node:-:B arg_node:-:A add_entity_node:-:missouri:=:river arg_node:-:B return:-:A
what is the biggest city in the us ?	add_operation:-:_largest add_node:-:A add_type_node:-:_city arg_node:-:A add_node:-:B add_edge:-:_loc arg_node:-:A arg_node:-:B add_entity_node:-:usa:=:country arg_node:-:B end_operation:-:arg ope_for:-:A return:-:A
how big is new mexico ?	add_node:-:B add_node:-:A add_edge:-:_size arg_node:-:B arg_node:-:A add_entity_node:-:new_mexico:=:state arg_node:-:B return:-:A
how many people live in south dakota ?	add_node:-:B add_node:-:A add_edge:-:_population arg_node:-:B arg_node:-:A add_entity_node:-:south_dakota:=:state arg_node:-:B return:-:A
what state is pittsburgh in ?	add_node:-:A add_type_node:-:_state arg_node:-:A add_node:-:B add_edge:-:_loc arg_node:-:B arg_node:-:A add_entity_node:-:pittsburgh:=:city arg_node:-:B return:-:A
what rivers run through arizona ?	add_node:-:A add_type_node:-:_river arg_node:-:A add_node:-:B add_edge:-:_traverse arg_node:-:A arg_node:-:B add_entity_node:-:arizona:=:state arg_node:-:B return:-:A
how many major rivers cross ohio ?	add_operation:-:_count add_node:-:B add_type_node:-:_major arg_node:-:B add_type_node:-:_river arg_node:-:B add_node:-:C add_edge:-:_traverse arg_node:-:B arg_node:-:C add_entity_node:-:ohio:=:state arg_node:-:C end_operation:-:_count ope_for:-:B ope_return:-:A return:-:A
how many people in boulder ?	add_node:-:B add_node:-:A add_edge:-:_population arg_node:-:B arg_node:-:A add_entity_node:-:boulder:=:city arg_node:-:B return:-:A
how many rivers are there in idaho ?	add_operation:-:_count add_node:-:B add_type_node:-:_river arg_node:-:B add_node:-:C add_edge:-:_loc arg_node:-:B arg_node:-:C add_entity_node:-:idaho:=:state arg_node:-:C end_operation:-:_count ope_for:-:B ope_return:-:A return:-:A
sacramento is the capital of which state ?	add_node:-:B add_entity_node:-:sacramento:=:city arg_node:-:B add_type_node:-:_capital arg_node:-:B add_node:-:A add_edge:-:_loc arg_node:-:B arg_node:-:A add_type_node:-:_state arg_node:-:A return:-:A
how many cities are there in us ?	add_operation:-:_count add_node:-:B add_type_node:-:_city arg_node:-:B add_node:-:C add_edge:-:_loc arg_node:-:B arg_node:-:C add_entity_node:-:usa:=:country arg_node:-:C end_operation:-:_count ope_for:-:B ope_return:-:A return:-:A
how many citizens live in california ?	add_node:-:B add_node:-:A add_edge:-:_population arg_node:-:B arg_node:-:A add_entity_node:-:california:=:state arg_node:-:B return:-:A
what state has the largest urban population ?	add_operation:-:_largest add_node:-:A add_type_node:-:_state arg_node:-:A add_node:-:B add_edge:-:_population arg_node:-:A arg_node:-:B end_operation:-:arg ope_for:-:B return:-:A
what states border the mississippi river ?	add_node:-:A add_type_node:-:_state arg_node:-:A add_node:-:B add_edge:-:_next_to arg_node:-:A arg_node:-:B add_entity_node:-:mississippi:=:river arg_node:-:B add_type_node:-:_river arg_node:-:B return:-:A
what can you tell me about the population of missouri ?	add_node:-:B add_node:-:A add_edge:-:_population arg_node:-:B arg_node:-:A add_entity_node:-:missouri:=:state arg_node:-:B return:-:A
what rivers do not run through tennessee ?	add_node:-:A add_type_node:-:_river arg_node:-:A add_operation:-:_not add_node:-:B add_edge:-:_traverse arg_node:-:A arg_node:-:B add_entity_node:-:tennessee:=:state arg_node:-:B end_operation:-:_not return:-:A
what is the largest city in a state that borders texas ?	add_operation:-:_largest add_node:-:A add_type_node:-:_city arg_node:-:A add_node:-:B add_edge:-:_loc arg_node:-:A arg_node:-:B add_type_node:-:_state arg_node:-:B add_node:-:C add_edge:-:_next_to arg_node:-:B arg_node:-:C add_entity_node:-:texas:=:state arg_node:-:C end_operation:-:arg ope_for:-:A return:-:A
name the longest river in us ?	add_operation:-:_longest add_node:-:A add_type_node:-:_river arg_node:-:A add_node:-:B add_edge:-:_loc arg_node:-:A arg_node:-:B add_entity_node:-:usa:=:country arg_node:-:B end_operation:-:arg ope_for:-:A return:-:A
how many states does the mississippi run through ?	add_operation:-:_count add_node:-:B add_type_node:-:_state arg_node:-:B add_node:-:C add_edge:-:_traverse arg_node:-:C arg_node:-:B add_entity_node:-:mississippi:=:river arg_node:-:C end_operation:-:_count ope_for:-:B ope_return:-:A return:-:A
what is the largest of the state that the rio grande runs through ?	add_operation:-:_largest add_node:-:A add_type_node:-:_state arg_node:-:A add_node:-:B add_edge:-:_traverse arg_node:-:B arg_node:-:A add_entity_node:-:rio_grande:=:river arg_node:-:B end_operation:-:arg ope_for:-:A return:-:A
what is the size of the capital of texas ?	add_node:-:B add_node:-:A add_edge:-:_size arg_node:-:B arg_node:-:A add_type_node:-:_capital arg_node:-:B add_node:-:C add_edge:-:_loc arg_node:-:B arg_node:-:C add_entity_node:-:texas:=:state arg_node:-:C return:-:A
what states have rivers running through them ?	add_node:-:A add_type_node:-:_state arg_node:-:A add_node:-:B add_edge:-:_loc arg_node:-:B arg_node:-:A add_type_node:-:_river arg_node:-:B add_edge:-:_traverse arg_node:-:B arg_node:-:A return:-:A
what states border hawaii ?	add_node:-:A add_type_node:-:_state arg_node:-:A add_node:-:B add_edge:-:_next_to arg_node:-:A arg_node:-:B add_entity_node:-:hawaii:=:state arg_node:-:B return:-:A
how many citizens in boulder ?	add_node:-:B add_node:-:A add_edge:-:_population arg_node:-:B arg_node:-:A add_entity_node:-:boulder:=:city arg_node:-:B return:-:A
what states border states that border states that border florida ?	add_node:-:A add_type_node:-:_state arg_node:-:A add_node:-:B add_edge:-:_next_to arg_node:-:A arg_node:-:B add_type_node:-:_state arg_node:-:B add_node:-:C add_edge:-:_next_to arg_node:-:B arg_node:-:C add_type_node:-:_state arg_node:-:C add_node:-:D add_edge:-:_next_to arg_node:-:C arg_node:-:D add_entity_node:-:florida:=:state arg_node:-:D return:-:A
which states border the longest river in the usa ?	add_node:-:A add_type_node:-:_state arg_node:-:A add_node:-:B add_edge:-:_next_to arg_node:-:A arg_node:-:B add_operation:-:_longest add_type_node:-:_river arg_node:-:B add_node:-:C add_edge:-:_loc arg_node:-:B arg_node:-:C add_entity_node:-:usa:=:country arg_node:-:C end_operation:-:arg ope_for:-:B return:-:A
what is the population density of wyoming ?	add_node:-:B add_node:-:A add_edge:-:_density arg_node:-:B arg_node:-:A add_entity_node:-:wyoming:=:state arg_node:-:B return:-:A
how many people are there in iowa ?	add_node:-:B add_node:-:A add_edge:-:_population arg_node:-:B arg_node:-:A add_entity_node:-:iowa:=:state arg_node:-:B return:-:A
what is the highest point in the state with the most rivers ?	add_operation:-:_highest add_node:-:A add_type_node:-:_place arg_node:-:A add_node:-:B add_edge:-:_loc arg_node:-:A arg_node:-:B add_operation:-:_most add_type_node:-:_state arg_node:-:B add_node:-:C add_edge:-:_traverse arg_node:-:C arg_node:-:B add_type_node:-:_river arg_node:-:C end_operation:-:arg_count ope_for:-:B ope_for:-:C end_operation:-:arg ope_for:-:A return:-:A
number of citizens in boulder ?	add_node:-:B add_node:-:A add_edge:-:_population arg_node:-:B arg_node:-:A add_entity_node:-:boulder:=:city arg_node:-:B return:-:A
what are the rivers of montana ?	add_node:-:A add_type_node:-:_river arg_node:-:A add_node:-:B add_edge:-:_loc arg_node:-:A arg_node:-:B add_entity_node:-:montana:=:state arg_node:-:B return:-:A
how many states border on the state whose capital is boston ?	add_operation:-:_count add_node:-:B add_type_node:-:_state arg_node:-:B add_node:-:C add_edge:-:_next_to arg_node:-:B arg_node:-:C add_type_node:-:_state arg_node:-:C add_node:-:D add_edge:-:_loc arg_node:-:D arg_node:-:C add_type_node:-:_capital arg_node:-:D add_entity_node:-:boston:=:city arg_node:-:D end_operation:-:_count ope_for:-:B ope_return:-:A return:-:A
how many people live in washington ?	add_node:-:B add_node:-:A add_edge:-:_population arg_node:-:B arg_node:-:A add_entity_node:-:washington:=:state arg_node:-:B return:-:A
what is the largest state capital in population ?	add_operation:-:_largest add_node:-:C add_type_node:-:_state arg_node:-:C add_node:-:A add_edge:-:_capital arg_node:-:C arg_node:-:A add_node:-:B add_edge:-:_population arg_node:-:A arg_node:-:B end_operation:-:arg ope_for:-:B return:-:A
what is the largest city in states that border california ?	add_operation:-:_largest add_node:-:A add_type_node:-:_city arg_node:-:A add_node:-:B add_edge:-:_loc arg_node:-:A arg_node:-:B add_type_node:-:_state arg_node:-:B add_node:-:C add_edge:-:_next_to arg_node:-:B arg_node:-:C add_entity_node:-:california:=:state arg_node:-:C end_operation:-:arg ope_for:-:A return:-:A
what is the most populous city in wyoming ?	add_operation:-:_largest add_node:-:A add_node:-:B add_edge:-:_population arg_node:-:A arg_node:-:B add_type_node:-:_city arg_node:-:A add_node:-:C add_edge:-:_loc arg_node:-:A arg_node:-:C add_entity_node:-:wyoming:=:state arg_node:-:C end_operation:-:arg ope_for:-:B return:-:A
what is the population density in the state with capital austin ?	add_node:-:B add_node:-:A add_edge:-:_density arg_node:-:B arg_node:-:A add_type_node:-:_state arg_node:-:B add_node:-:C add_edge:-:_loc arg_node:-:C arg_node:-:B add_type_node:-:_capital arg_node:-:C add_entity_node:-:austin:=:city arg_node:-:C return:-:A
what is the population of portland maine ?	add_node:-:B add_node:-:A add_edge:-:_population arg_node:-:B arg_node:-:A add_entity_node:-:portland_me:=:city arg_node:-:B return:-:A
which state is kalamazoo in ?	add_node:-:A add_type_node:-:_state arg_node:-:A add_node:-:B add_edge:-:_loc arg_node:-:B arg_node:-:A add_entity_node:-:kalamazoo:=:city arg_node:-:B return:-:A
what is the population of the largest state that borders texas ?	add_node:-:B add_node:-:A add_edge:-:_population arg_node:-:B arg_node:-:A add_operation:-:_largest add_type_node:-:_state arg_node:-:B add_node:-:C add_edge:-:_next_to arg_node:-:B arg_node:-:C add_entity_node:-:texas:=:state arg_node:-:C end_operation:-:arg ope_for:-:B return:-:A
what states border ohio ?	add_node:-:A add_type_node:-:_state arg_node:-:A add_node:-:B add_edge:-:_next_to arg_node:-:A arg_node:-:B add_entity_node:-:ohio:=:state arg_node:-:B return:-:A
what river is the longest one in the united states ?	add_operation:-:_longest add_node:-:A add_type_node:-:_river arg_node:-:A add_node:-:B add_edge:-:_loc arg_node:-:A arg_node:-:B add_entity_node:-:usa:=:country arg_node:-:B end_operation:-:arg ope_for:-:A return:-:A
what is the population density of the state with the smallest area ?	add_node:-:B add_node:-:A add_edge:-:_density arg_node:-:B arg_node:-:A add_operation:-:_smallest add_type_node:-:_state arg_node:-:B add_node:-:C add_edge:-:_area arg_node:-:B arg_node:-:C end_operation:-:arg ope_for:-:C return:-:A
what is the largest capital ?	add_operation:-:_largest add_node:-:A add_type_node:-:_capital arg_node:-:A end_operation:-:arg ope_for:-:A return:-:A
what state has the smallest capital ?	add_node:-:A add_type_node:-:_state arg_node:-:A add_node:-:B add_edge:-:_loc arg_node:-:B arg_node:-:A add_operation:-:_smallest add_type_node:-:_capital arg_node:-:B end_operation:-:arg ope_for:-:B return:-:A
how many big cities are in pennsylvania ?	add_operation:-:_count add_node:-:B add_type_node:-:_major arg_node:-:B add_type_node:-:_city arg_node:-:B add_node:-:C add_edge:-:_loc arg_node:-:B arg_node:-:C add_entity_node:-:pennsylvania:=:state arg_node:-:C end_operation:-:_count ope_for:-:B ope_return:-:A return:-:A
which states lie on the largest river in the united states ?	add_node:-:A add_type_node:-:_state arg_node:-:A add_node:-:B add_edge:-:_traverse arg_node:-:B arg_node:-:A add_operation:-:_largest add_type_node:-:_river arg_node:-:B add_node:-:C add_edge:-:_loc arg_node:-:B arg_node:-:C add_entity_node:-:usa:=:country arg_node:-:C end_operation:-:arg ope_for:-:B return:-:A
where is houston ?	add_node:-:B add_node:-:A add_edge:-:_loc arg_node:-:B arg_node:-:A add_entity_node:-:houston:=:city arg_node:-:B return:-:A
what rivers flow through states that border the state with the largest population ?	add_node:-:A add_type_node:-:_river arg_node:-:A add_node:-:B add_edge:-:_traverse arg_node:-:A arg_node:-:B add_type_node:-:_state arg_node:-:B add_node:-:C add_edge:-:_next_to arg_node:-:B arg_node:-:C add_operation:-:_largest add_type_node:-:_state arg_node:-:C add_node:-:D add_edge:-:_population arg_node:-:C arg_node:-:D end_operation:-:arg ope_for:-:D return:-:A
what is the highest point in the smallest state ?	add_operation:-:_highest add_node:-:A add_type_node:-:_place arg_node:-:A add_node:-:B add_edge:-:_loc arg_node:-:A arg_node:-:B add_operation:-:_smallest add_type_node:-:_state arg_node:-:B end_operation:-:arg ope_for:-:B end_operation:-:arg ope_for:-:A return:-:A
what river runs through virginia ?	add_node:-:A add_type_node:-:_river arg_node:-:A add_node:-:B add_edge:-:_traverse arg_node:-:A arg_node:-:B add_entity_node:-:virginia:=:state arg_node:-:B return:-:A
what state borders michigan ?	add_node:-:A add_type_node:-:_state arg_node:-:A add_node:-:B add_edge:-:_next_to arg_node:-:A arg_node:-:B add_entity_node:-:michigan:=:state arg_node:-:B return:-:A
name the major lakes in michigan ?	add_node:-:A add_type_node:-:_major arg_node:-:A add_type_node:-:_lake arg_node:-:A add_node:-:B add_edge:-:_loc arg_node:-:A arg_node:-:B add_entity_node:-:michigan:=:state arg_node:-:B return:-:A
give me the cities in virginia ?	add_node:-:A add_type_node:-:_city arg_node:-:A add_node:-:B add_edge:-:_loc arg_node:-:A arg_node:-:B add_entity_node:-:virginia:=:state arg_node:-:B return:-:A
which river runs through the most states ?	add_operation:-:_most add_node:-:A add_type_node:-:_river arg_node:-:A add_node:-:B add_edge:-:_traverse arg_node:-:A arg_node:-:B add_type_node:-:_state arg_node:-:B end_operation:-:arg_count ope_for:-:A ope_for:-:B return:-:A
how many people live in new mexico ?	add_node:-:B add_node:-:A add_edge:-:_population arg_node:-:B arg_node:-:A add_entity_node:-:new_mexico:=:state arg_node:-:B return:-:A
what is the largest city in alabama ?	add_operation:-:_largest add_node:-:A add_type_node:-:_city arg_node:-:A add_node:-:B add_edge:-:_loc arg_node:-:A arg_node:-:B add_entity_node:-:alabama:=:state arg_node:-:B end_operation:-:arg ope_for:-:A return:-:A
how many people live in san francisco ?	add_node:-:B add_node:-:A add_edge:-:_population arg_node:-:B arg_node:-:A add_entity_node:-:san_francisco:=:city arg_node:-:B return:-:A
what is the population of the capital of the largest state ?	add_node:-:B add_node:-:A add_edge:-:_population arg_node:-:B arg_node:-:A add_type_node:-:_capital arg_node:-:B add_node:-:C add_edge:-:_loc arg_node:-:B arg_node:-:C add_operation:-:_largest add_type_node:-:_state arg_node:-:C end_operation:-:arg ope_for:-:C return:-:A
what is the longest river in the us ?	add_operation:-:_longest add_node:-:A add_type_node:-:_river arg_node:-:A add_node:-:B add_edge:-:_loc arg_node:-:A arg_node:-:B add_entity_node:-:usa:=:country arg_node:-:B end_operation:-:arg ope_for:-:A return:-:A
what is the largest state that borders the state with the highest population ?	add_operation:-:_largest add_node:-:A add_type_node:-:_state arg_node:-:A add_node:-:B add_edge:-:_next_to arg_node:-:A arg_node:-:B add_operation:-:_largest add_type_node:-:_state arg_node:-:B add_node:-:C add_edge:-:_population arg_node:-:B arg_node:-:C end_operation:-:arg ope_for:-:C end_operation:-:arg ope_for:-:A return:-:A
show me all the major lakes in the us ?	add_node:-:A add_type_node:-:_major arg_node:-:A add_type_node:-:_lake arg_node:-:A add_node:-:B add_edge:-:_loc arg_node:-:A arg_node:-:B add_entity_node:-:usa:=:country arg_node:-:B return:-:A
where is springfield ?	add_node:-:B add_node:-:A add_edge:-:_loc arg_node:-:B arg_node:-:A add_entity_node:-:springfield:=:city arg_node:-:B return:-:A
what state is des moines located in ?	add_node:-:A add_type_node:-:_state arg_node:-:A add_node:-:B add_edge:-:_loc arg_node:-:B arg_node:-:A add_entity_node:-:des_moines:=:city arg_node:-:B return:-:A
how many cities does texas have ?	add_operation:-:_count add_node:-:B add_type_node:-:_city arg_node:-:B add_node:-:C add_edge:-:_loc arg_node:-:B arg_node:-:C add_entity_node:-:texas:=:state arg_node:-:C end_operation:-:_count ope_for:-:B ope_return:-:A return:-:A
what state is boston in ?	add_node:-:A add_type_node:-:_state arg_node:-:A add_node:-:B add_edge:-:_loc arg_node:-:B arg_node:-:A add_entity_node:-:boston:=:city arg_node:-:B return:-:A
